Id,Title,Solved?,Author,Difficulty,Liked,Disliked,Like-Dislike
13259,Radius,,axorion,?,0,0,0
13258,Radius,,axorion,?,0,0,0
13257,butterfly,,1234alberto,2.33,4,0,4
13256,ENGR101(Iteration),,engr101group,1.60,5,-1,4
13255,Tailhook,,axorion,2.25,3,0,3
13254,Example,,ESPgroup5,1.14,4,-1,3
13253,Engr 101 - Function Calls,,hsdag,1.17,2,-1,1
13252,Engr 101 - Brandon Wolski,,hsdag,1.50,1,-1,0
13251,Karate Man,,etmervic123,3.00,1,-1,0
13250,Steve,,ENGR101G3,1.50,1,-1,0
13249,The Right Task For The Job,,kyleinth,2.33,0,0,0
13248,Double tour,,kroustof,1.67,4,0,4
13247,Paint,,J_Three,1.50,1,0,1
13246,Pain,,J_Three,2.25,2,-2,0
13245,Iteration and selection,,J_Three,2.00,5,-1,4
13244,Mr Jolly,,engr101_g6,2.00,2,-1,1
13243,Iteration ,,J_Three,2.00,4,-1,3
13242,two way arrow,,uicgroup3,2.00,1,-1,0
13241,Stripes ,,Group3,1.60,2,-3,-1
13240,Iteration G3,,Group3,1.00,6,-2,4
13239,Easy Selection,,Group3,1.00,5,-4,1
13238,two way call,,ENGR101G3,1.75,3,-1,2
13237,BlankFace,,ENGR101G3,1.00,2,-5,-3
13236,Swoosh,,syedhh2,1.14,3,-1,2
13230,snake,,BruhMachine,1.00,2,-3,-1
13221,two stair case,,ESPgroup5,1.86,5,-1,4
13214,FunctionCall,,uicgroup3,1.14,4,-2,2
13206,Red turn-Selectiom,,ENGR101G3,1.60,1,0,1
13203,:whale2: challenge test,,whale,2.33,3,0,3
13202,ESP group 5 challenge puzzle 2,,ESPgroup5,1.75,1,-1,0
13201,Group_2_iteration,,garyzhangxd,1.00,2,-4,-2
13199,Group_04_Selection,,hsdag,1.00,1,-2,-1
13184,Hmm2,,whale,3.00,3,-1,2
13164,Unsquared,,group5engr101,1.71,3,-1,2
13163,Cross Walk,,Engr101group99,1.75,2,0,2
13162,Joshua_Martinez_Puzzle,,whale,2.00,2,-1,1
13161,"Puzzle 5: function calls, selection",,2pm_group3_uic,1.50,2,-1,1
13160,"Puzzle 5: Function calls, Selection",,2pm_group3_uic,1.50,1,-1,0
13159,Spam Functions,,syedhh2,1.50,1,-1,0
13158,IM bad at this,,etmervic123,1.50,2,-1,1
13157,Painter's Paradise,,kyleinth,1.40,1,-1,0
13156,Simple Iteration,,hsdag,1.40,1,-1,0
13155,maze,,etmervic123,1.29,4,-5,-1
13154,Challenge #1 - Group 5,,group5,2.00,1,-1,0
13153,"A new ally, or a new storm?",,hsdag,2.50,1,0,1
13152,"...No, no, that was a dead end.",,2pm_group3_uic,3.00,2,0,2
13151,Challenge Puzzle #2,,group5,1.25,1,-1,0
13146,Question Mark,,BruhMachine,1.75,0,-1,-1
13145,Galaga,,Engr101group99,1.00,3,-4,-1
13144,Figure 8,,BruhMachine,1.00,1,-3,-2
13143,Stair with colors,,kyleinth,1.25,0,-1,-1
13142,Two choices,,kyleinth,1.00,0,-3,-3
13141,Stacked Snake,,kyleinth,1.00,0,-1,-1
13140,Turn on Red and Green,,group3_uic,1.40,2,-1,1
13139,A simple Iteration ,,ENGR101,1.11,5,-2,3
13138,Stairway to Heaven,,ESPgroup5,1.40,2,-1,1
13137,Hidden Snake,,Engr101group99,2.00,1,-1,0
13136,Escape,,ENGR101,2.14,2,-1,1
13135,OWL,,Engr101group99,3.00,0,-1,-1
13134,Functionception,,etmervic123,2.00,1,-1,0
13133,X - MEN ,,etmervic123,2.00,2,-1,1
13132,Back to the start,,group5engr101,1.00,2,-3,-1
13131,Function Lamp,,Engr101group99,1.50,3,-1,2
13130,Up and Down the Stairs,,etmervic123,1.50,2,-1,1
13129,Impossible Ladder,,group5engr101,1.67,0,-1,-1
13128,Selection,,syedhh2,1.50,1,0,1
13127,group 3 9am puzzle 2,,uicgroup3,2.00,0,-1,-1
13126,Ductile,,axorion,3.00,0,0,0
13125,Break the Loop,,ESPgroup5,2.00,3,-1,2
13124,Function Call,,SKEBS,2.00,4,0,4
13123,Selection ,,engr101group,1.00,1,-3,-2
13122,Group_5_Puzzle_4,,ENGR101GROUP5,1.80,1,-1,0
13121,Group_5_Puzzle_2,,ENGR101GROUP5,2.20,3,0,3
13120,Hmm,,whale,2.20,1,-1,0
13119,Function Calls,,engr101group,1.00,2,-3,-1
13118,Quench,,axorion,3.00,1,0,1
13117,Selection,,SKEBS,1.50,1,-1,0
13116,Selection Puzzle,,SKEBS,1.00,0,-1,-1
13115,CHOOSE PATH,,Engr101group99,1.38,4,-4,0
13114,Iteration Puzzle ,,SKEBS,1.00,1,-5,-4
13113,Nested Functions,,TEAMRZA,2.00,1,-1,0
13110,Selection and Function Calls,,SKEBS,1.00,2,-3,-1
13109,Functional Iteration,,TEAMRZA,2.00,2,-1,1
13108,Selection and Iteration,,SKEBS,1.17,0,-2,-2
13107,Hammerhead,,group5,1.75,2,0,2
13106,ENGR 101,,tctpatel,1.00,2,-1,1
13105,ENGR 101,,tctpatel,1.75,1,0,1
13104,swingset,,beta,1.25,3,-1,2
13103,Who am I ?,,etmervic123,1.00,1,-3,-2
13102,:whale2: iteration,,whale,1.67,3,0,3
13101,:whale2: selection,,whale,1.00,0,-3,-3
13100,Team RZA Selection,,TEAMRZA,1.00,0,-2,-2
13099,triangle,,syedhh2,1.80,2,0,2
13098,team1,,syedhh2,1.20,3,0,3
13097,Left or Right,,TeamNoName,1.33,1,-1,0
13096,selection v2,,ENGR101_G6,1.20,1,-1,0
13095,Iteration,,TEAMRZA,1.50,1,-1,0
13094,easy one,,TEAMRZA,1.50,0,-1,-1
13093,TEAMRZA1,,TEAMRZA,1.00,2,-5,-3
13092,easy choice,,Group3,1.00,1,-3,-2
13091,Selection Engr101_g6,,ENGR101_G6,1.00,0,-1,-1
13090,Tested and Fully Functional,,TEAMRZA,1.60,1,-1,0
13089,engr101 p5,,strelitzia,1.83,3,-1,2
13088,Physical Storage,,2pm_group3_uic,1.71,5,0,5
13087,Engr101,,tctpatel,1.50,1,-1,0
13086,ENGR 101,,tctpatel,1.50,2,-1,1
13085,The Window ,,Group3,1.29,2,-3,-1
13084,Engr101,,tctpatel,1.00,0,-2,-2
13083,Engr101,,tctpatel,1.25,1,-1,0
13082,Alternating calls,,BruhMachine,1.67,0,0,0
13081,Stair1,,beta,1.00,2,-4,-2
13080,Learn Select,,BruhMachine,1.50,1,-1,0
13079,Engr101,,tctpatel,1.00,2,-6,-4
13078,Red Tile Green Tile,,BruhMachine,1.20,1,-1,0
13077,Staircase,,ENGR101G3,1.50,1,-1,0
13076,Binary wonderland,,DanielleAnn,1.33,1,-1,0
13075,Star Iteration,,TeamNoName,2.67,0,0,0
13074,Iteration2.0,,uicgroup3,1.50,1,-1,0
13073,F for our fallen F,,TeamNoName,1.80,3,0,3
13072,Iteration & Selection,,uicgroup3,1.50,2,-1,1
13071,Color Blind,,TeamNoName,2.00,1,-1,0
13070,Cross,,TeamNoName,1.40,0,-1,-1
13069,tan,,beta,1.50,1,-1,0
13068,Triangle,,group3_uic,1.80,3,0,3
13067,Country Lane,,group3_uic,2.80,2,-1,1
13066,Skull,,group5engr101,1.60,3,-1,2
13065,sdajfn,,beta,1.00,1,-3,-2
13064,KASA: Puzzle (Iteration),,KASA,2.50,2,0,2
13063,Red Dead Ends,,2pm_group3_uic,1.83,4,0,4
13062,Challenge Puzzle #1,,group5,1.00,1,-4,-3
13061,x mark with star,,DanielleAnn,1.40,0,-1,-1
13051,Coraz√≥n ,,LidiaFabregas,1.40,1,-1,0
13050,Throwing heart ,,DanielleAnn,2.00,1,-1,0
13049,Simple puzzle,,beta,1.00,3,-5,-2
13048,Iteration and Selection,,uic_group1,1.29,3,-2,1
13047,Robozzlers!,,uic_group1,1.00,3,-3,0
13046,Selection,,uic_group1,1.00,1,-3,-2
13045,Swiggity Swooty,,DanielleAnn,1.33,3,-2,1
13044,selection/iteration,,ENGR101,1.00,1,-3,-2
13043,snake,,ENGR101,1.20,1,-2,-1
13042,Triforce,,DanielleAnn,3.00,1,0,1
13041,Function call,,MDI_ENGR101,1.75,1,0,1
13040,Iteration function call,,agasco3,2.00,2,-1,1
13039,A simple Happy Face,,group10,1.40,1,0,1
13038,KASA: Puzzle (Selection),,KASA,1.25,0,-1,-1
13037,Group4 Iteration and Selection ,,group4,1.33,2,-1,1
13036,KASA: Taking a detour,,KASA,2.25,1,-1,0
13035,Checkerboard,,strelitzia,1.17,2,-1,1
13019,Group_5_Puzzle_3,,ENGR101GROUP5,1.50,5,-4,1
13018,Swing_Man,,ENGR101GROUP5,1.67,2,0,2
13017,Group_5_Puzzle_1,,ENGR101GROUP5,1.17,4,-2,2
13016,Fallen S,,ENGR101,1.33,1,-2,-1
13015,Round about,,strelitzia,1.00,1,-3,-2
13014,Selection,,J_Three,1.71,4,-1,3
13013,Function Call Puzzle!,,KASA,1.67,1,-1,0
13012,Simple Cross,,ESPgroup5,1.57,3,-1,2
13011,Selection(1),,uic_engr101,1.00,3,-3,0
13010,Selection,,uic_engr101,1.40,1,-1,0
13009,Puzzle using Selection,,uic_engr101,1.75,1,0,1
13008,Selection,,agasco3,1.00,2,-4,-2
13007,Iteration,,agasco3,1.00,3,-3,0
13006,Function Call,,agasco3,1.33,1,-1,0
13005,Function Call and Selection,,agasco3,1.00,1,-5,-4
13004,Function Call and Selection,,agasco3,1.13,3,-4,-1
13003,Basic Function Call,,engr101group,1.40,2,-1,1
13002,All 3 in One,,beta,1.00,2,-1,1
13001,Selection + Iteration,,group4,1.67,4,0,4
13000,Easily,,group4,1.50,3,-1,2
12999,Heart ,,group5engr101,1.14,3,-1,2
12998,ENGR101 Call Functions,,engr101_g6,2.75,3,0,3
12997,Cacatus,,ENGR101_G6,2.60,4,0,4
12996,ENGR 101 TUE G2,,garyzhangxd,1.00,3,-5,-2
12995,ENGR 101 G2 puzzle,,garyzhangxd,1.11,3,-5,-2
12994,ENGR 101 TUE G2 puzzle,,garyzhangxd,1.50,2,-1,1
12993,easy one!!,,group4,1.00,7,-2,5
12992,ENGR 101 g2,,garyzhangxd,1.00,3,-4,-1
12991,ENGR 101 G2 selection,,garyzhangxd,1.13,2,-2,0
12990,Csimple,,mdi_engr101,1.50,0,-1,-1
12989,Engr101 Group8,,_Group_8,1.33,5,-1,4
12988,Simple,,mdi_engr101,1.17,2,-2,0
12987,ENGL101 G8 ex.02,,_Group_8,1.00,1,-5,-4
12986,ENG101 ,,_Group_8,1.00,7,-6,1
12985,RNGR101 G8 Function call ex.01,,_Group_8,1.50,2,-2,0
12984,Choice/functions - ENGR101_G6,,ENGR101_G6,1.80,2,-1,1
12983,Iteration,,ENGR101_G6,1.50,3,-1,2
12982,Call the Functions,,Engr101HTW,1.80,3,-1,2
12981,Iteration - No breathing,,Engr101HTW,1.83,2,-1,1
12980,Engr 101 G8 iteration,,_Group_8,1.11,5,-3,2
12979,Hollow Turkey,,group10,1.75,1,-2,-1
12978,Taunting Smile,,group10,1.75,2,-1,1
12977,Quilted Pattern,,Toast_,2.00,0,-1,-1
12976,strelitzia 2,,strelitzia,1.43,2,-1,1
12975,strelitzia1,,strelitzia,1.43,2,-1,1
12974,"ENGR101: Selection, Iteration and Function calls!",,KASA,2.25,1,-1,0
12973,Go Back,,engr101group,3.00,1,0,1
12972,The Road to Madness,,axorion,?,0,0,0
12971,Labyrinth,,2pm_group3_uic,2.00,4,0,4
12970,Monolithic Stack,,2pm_group3_uic,1.44,3,-1,2
12969,Will the call stack be on the test?,,axorion,2.33,6,0,6
12968,FunctionPuzzle,,Engr101HTW,1.22,2,-3,-1
12967,CombinationPuzzle,,Engr101HTW,1.75,4,-1,3
12966,Iteration + Function ,,group4,1.57,4,-1,3
12965,Simple Function Calls,,group5,1.67,3,-1,2
12964,All 3 Elements,,beta,1.67,4,-1,3
12963,Iteration Puzzle ESP101,,beta,1.57,1,-1,0
12962,Iteration,,group5,1.67,4,-2,2
12961,Painted into a corner,,group3_uic,2.50,3,0,3
12960,Group 1: Iteration,,uic_group1,1.57,6,-1,5
12959,function call puzzle,,uic_group1,1.83,3,0,3
12958,+,,group3_uic,1.33,5,-1,4
12957,Brine Tank,,MDI_ENGR101,1.83,2,-1,1
12956,Brine Tank,,MDI_ENGR101,1.50,0,-1,-1
12955,Brine Tank,,MDI_ENGR101,1.80,3,-1,2
12954,RGB Squares ,,group10,1.14,3,-1,2
12953,Mariposa Metirozzaaa,,uic_engr101,2.50,1,-1,0
12952,Keep on the path,,ptroy,1.17,2,-1,1
12951,Sergio Has Fallen,,uic_engr101,1.50,3,-1,2
12950,Selection Puzzle,,Engr101HTW,1.25,2,-1,1
12949,Group2 ENGR 101,,garyzhangxd,1.00,0,-3,-3
12948,Group2 ENGR 101,,garyzhangxd,1.00,4,-3,1
12947,Iteration+function call,,garyzhangxd,1.13,3,-3,0
12946,Ismael Puzzle,,uic_engr101,1.00,7,-3,4
12945,Puzzle iteration ,,uic_engr101,2.00,1,-2,-1
12944,Puzzle iteration ,,uic_engr101,1.13,5,-3,2
12943,Puzzle 1,,uic_engr101,1.50,1,-2,-1
12942,Hot Summer Day,,MDI_ENGR101,1.50,1,-2,-1
12941,Heart,,LidiaFabregas,1.00,8,-3,5
12940,Learning To use loops,,snehil,1.11,4,-2,2
12939,Cup,,MDI_ENGR101,1.38,1,-1,0
12938,THE STAR MAZE,,snehil,2.00,3,-1,2
12937,The chamber of secrets,,group10,2.17,3,-1,2
12936,"""Cross""",,group10,1.40,2,0,2
12935,Patriotic Ribbon,,group10,1.00,4,-2,2
12934,Mainly on functions,,group10,2.00,2,-1,1
12933,ENGR 101 Sample,,ptroy,1.43,4,-2,2
12932,The Red Tailed Puzzle,,axorion,?,0,0,0
12931,what do I have to do?,,_jounes,2.33,3,-1,2
12930,Happy Christmas,,Denyvoda ,2.83,5,0,5
12929,Notched,,axorion,2.80,3,0,3
12928,So simple,,LidiaFabregas,1.50,5,-2,3
12927,4x4,,mkp777,2.13,5,-1,4
12926,Ocho,,LidiaFabregas,1.18,5,-3,2
12925,d√° para pegar essa estrela!!!,,Vinicius2608,1.50,3,-1,2
12924,zumbizinho,,Vinicius2608,1.05,15,-7,8
12923,O nove das estrelas,,Vinicius2608,1.18,7,-3,4
12921,S√∫per F√°c,,LidiaFabregas,1.05,13,-7,6
12920,Cazando Estrellas,,LidiaFabregas,1.36,5,-1,4
12919,La mejor Escaladora,,LidiaFabregas,1.00,15,-6,9
12918,Demasiadas Estrellas,,LidiaFabregas,1.19,6,-3,3
12917,erm its ez,,zyleak,1.24,9,-6,3
12916,ÙˆÚÛS¯o,,zyleak,1.22,4,-3,1
12915,a porkchop from minecraft,,zyleak,1.50,4,-2,2
12914,lvl 2 why does this look like a bird somehow,,zyleak,1.44,4,-2,2
12913,Light edition of Color Line-Turning? ,,Denyvoda ,3.00,1,0,1
12912,Prime Generator (Sieve of Eratosthenes),,scorpio,5.00,1,0,1
12911,late stairs,,5joshi,1.56,3,-2,1
12910,Cumulative Complexity,,axorion,2.40,5,0,5
12909,O cora√ß√,,Vinicius2608,1.44,3,-5,-2
12908,al√≠e,,Vinicius2608,1.33,4,-2,2
12907,e muito facil,,Vinicius2608,1.56,6,-4,2
12906,Cobra,,Vinicius2608,1.50,5,-2,3
12905,o que que √© isso,,Vinicius2608,1.33,8,-9,-1
12904,Odd & Even Tree Branches,,scorpio,3.00,5,0,5
12903,Circles is hard,,Denyvoda ,3.00,2,0,2
12902,Odd & Even Squares,,scorpio,3.00,1,0,1
12901,when you die of fall damage in a video game,,zyleak,1.43,11,-4,7
12900,this will hurt ur eyes dont hate me,,zyleak,1.45,6,-2,4
12899,Weirdness,,zyleak,1.50,5,-3,2
12898,Color Line,,padre,?,0,0,0
12897,Tree,,goshal,1.18,7,-2,5
12896,Don't be a square,,WrenTom,1.14,14,-7,7
12895,B√∫ssol,,AnaLuiza,1.19,10,-1,9
12894,Descendo a escada,,VagnerPaulino,1.25,9,-8,1
12893,Slightly assymetric,,kraker ,2.33,2,0,2
12892,Bifurcation,,scorpio,3.00,1,0,1
12891,ZigZag,,WrenTom,1.26,25,-5,20
12890,Broken Bifurcation,,scorpio,4.00,1,0,1
12889,Depth tree,,scorpio,3.50,2,0,2
12888,Stairs Complicated!,,ajayjha25,1.78,6,-1,5
12887,Almost a square,,ppetrov,2.00,4,0,4
12886,a knife,,zyleak,1.32,17,-2,15
12885,i want to get a goal of 100 likes,,air111116,1.31,7,-6,1
12884,2 Star Puzzle,,WrenTom,1.25,9,-4,5
12883,ACEA Puzzle 2 MM,,aceamm,1.04,17,-5,12
12882,ACEA Puzzle 1 MM,,aceamm,1.24,8,-5,3
12881,First Try,,WrenTom,1.83,39,-2,37
12880,Turning? 1,,padre,2.50,3,0,3
12879,tic-tac-toe board,,Original_Doge,1.27,7,-1,6
12878,compter,,serge91,1.70,5,-1,4
12877,hi,,air111116,1.31,11,-5,6
12876,hi zyleak part 3,,air111116,1.42,8,-3,5
12875,when noobs are bad,,zyleak,1.31,7,-2,5
12874,PLZ STOP AIR,,zyleak,1.33,18,-3,15
12873,The red tulip,,zyleak,1.25,5,-2,3
12872,Maze,,serge91,2.00,3,0,3
12871,WWWhhhaaattt!!!,,padre,2.00,3,0,3
12870,Shades til it disappears,,BalanceBreaker,2.13,9,0,9
12869,EAZZZY!,,Original_Doge,1.10,18,-5,13
12868,A Different spiral,,Original_Doge,1.38,5,-1,4
12867,confusion?,,Original_Doge,1.50,5,-1,4
12866,chill.,,Original_Doge,1.27,7,-4,3
12865,loopy stairs,,Original_Doge,1.50,4,-1,3
12864,hi zyleak p.2,,air111116,1.40,6,-2,4
12863,air why you offensive ????,,zyleak,1.16,17,-3,14
12862,two colors,,zyleak,1.50,4,-1,3
12861,hi Zyleak,,air111116,1.05,16,-5,11
12860,more trolololol 2 - ft. a messed up plant,,zyleak,1.20,3,-4,-1
12859,this is the most ugly face in the world,,zyleak,1.17,6,-4,2
12858,Criss Cross Pie,,zyleak,1.22,5,-2,3
12857,choices 2,,Original_Doge,1.40,5,0,5
12856,Hashtag,,padre,2.25,1,0,1
12855,THE BIG CAVE!,,padre,2.33,1,0,1
12854,a spiral,,tijl,2.00,6,0,6
12853,Bunch of T's!,,ajayjha25,1.70,4,-1,3
12852,hypnotism,,Original_Doge,1.50,5,-2,3
12851,treacherous walk,,Original_Doge,1.20,10,-4,6
12850,choose,,Original_Doge,1.19,13,-3,10
12849,Annoying iteration,,Original_Doge,1.15,9,-2,7
12848,branches,,Original_Doge,1.18,8,-2,6
12847,This is easy,,tijl,1.30,8,-1,7
12846,???,,tijl,1.56,5,-1,4
12845,Zyleak I am coming!!!,,air111116,1.29,11,-7,4
12844,tunnels,,zyleak,1.18,5,-3,2
12843,Little Blue Dots,,zyleak,1.33,6,-3,3
12842,this is a lines puzzle,,zyleak,1.27,6,-3,3
12841,Oh my lord,,zyleak,1.22,5,-2,3
12840,Checker Boards,,zyleak,1.38,3,-3,0
12839,Europe,,klontje_boter,1.43,5,-1,4
12838,LOL!!!,,klontje_boter,1.43,3,-1,2
12837,Trappen snake,,klontje_boter,1.57,4,-1,3
12836,Faster Than Light,,axorion,3.00,0,0,0
12835,Are you nice?????????,,zyleak,1.25,5,-2,3
12834,The Arrows,,zyleak,1.38,3,-3,0
12833,when waterfalls make an x,,zyleak,1.43,10,-3,7
12832,Water STaircase,,zyleak,1.05,16,-4,12
12831,THIS IS EASY,,zyleak,1.30,6,-2,4
12830,Happy time,,tijl,1.27,10,-2,8
12829,Spinny,,Original_Doge,1.44,5,-4,1
12828,ARF!,,Original_Doge,1.56,5,-1,4
12827,YUM.,,Original_Doge,1.20,8,-3,5
12826,Tricks,,Original_Doge,1.20,20,-8,12
12825,chain,,Original_Doge,1.50,5,-2,3
12824,more trolololol,,zyleak,1.27,6,-4,2
12823,Iteration 2000,,zyleak,1.04,23,-5,18
12822,yeet teey,,zyleak,1.14,12,-4,8
12821,I love this face,,zyleak,1.20,15,-2,13
12820,Out Of Reach,,axorion,3.25,3,0,3
12819,This is easy,,zyleak,1.16,18,-7,11
12818,Exponential,,dutchen18,2.29,3,0,3
12817,hardest,,smithia818,1.18,6,-2,4
12816,Repurposed,,axorion,3.33,3,0,3
12815,Endless waterfalls,,scorpio,4.00,1,0,1
12814,A challenge to younsle,,axorion,2.38,5,0,5
12813,Nine_stack,,younsle,1.63,4,-1,3
12812,The troll,,zyleak,1.33,17,-1,16
12811,The Box,,zyleak,1.27,17,-2,15
12810,The Blood Staircase,,zyleak,1.13,14,-1,13
12809,STAIRCASE,,zyleak,1.26,16,-5,11
12808,Multiple stacks in one function V,,scorpio,4.00,2,0,2
12807,Brazil,,Coroi199837,1.13,15,-2,13
12806,Colors separation (Lite edition),,scorpio,5.00,1,0,1
12805,Thoughts on Mazhar,,jnpollack,3.00,4,0,4
12804,E,,Bogerdj656,1.27,5,-1,4
12803,Boomerang paths XXS,,scorpio,2.50,1,0,1
12802,Vertigo illusion,,scorpio,4.00,3,0,3
12801,Pointless,,axorion,?,0,0,0
12800,Vertigo Delusion,,axorion,3.00,5,0,5
12799,Boomerang paths,,scorpio,3.00,2,0,2
12798,Boomerang paths (light edition),,scorpio,3.25,4,0,4
12797,Extreme,,axorion,4.50,2,0,2
12796,XOR Lines,,scorpio,3.00,2,0,2
12795,Bushnell's Law,,axorion,3.80,5,0,5
12794,Test,,MrMartin,1.82,7,-2,5
12793,tbh i dont know???,,LACav,1.88,4,-2,2
12792,Just Halfs,,drmazhar,3.20,5,0,5
12791,Maze,,micheltj212,?,0,0,0
12790,Maze,,micheltj212,?,0,0,0
12789,Nighthawk,,scorpio,3.67,3,0,3
12788,Pop At Green,,drmazhar,3.00,2,0,2
12787,1998,,axorion,3.00,1,0,1
12786,taiwan is not chinese,,jimmyfu,1.27,4,-2,2
12785,Antclockwise spiral,,drmazhar,3.40,3,0,3
12784,Corona Dispersion Algorithm,,drmazhar,2.00,4,0,4
12783,Distance or Direction,,drmazhar,2.80,3,0,3
12782,Heavy Dumbbell III,,drmazhar,2.67,2,0,2
12781,Monochromatic Sandglass,,scorpio,3.50,4,0,4
12780,Sandglass,,scorpio,2.80,5,0,5
12779,Light Dumbbell,,scorpio,3.50,4,0,4
12778,Circular Road includes Many Crosses,,drmazhar,2.60,4,0,4
12777,Coming Up Short,,axorion,3.50,1,0,1
12776,Heavy Dumbbell II,,drmazhar,3.00,2,0,2
12775,Over The Top,,axorion,3.25,4,0,4
12774,Double recursion,,goshal,2.60,5,0,5
12773,Midpoint,,goshal,2.00,4,0,4
12772,level 1,,Casualuser,1.21,60,-3,57
12771,Arrowhead,,scorpio,3.00,3,0,3
12770,Red & Greens ,,drmazhar,2.50,4,0,4
12769,Heavy Dumbbell,,scorpio,4.50,2,0,2
12768,Red's Condition,,drmazhar,3.00,3,0,3
12767,MED ,,Meddaif99,1.75,4,-2,2
12766,MED,,Meddaif99,1.75,4,0,4
12765,STC,,adeem69300,1.63,4,-2,2
12764,Green Shafted,,jnpollack,3.00,2,0,2
12763,"Count till Green ""Version 2""",,drmazhar,3.00,4,0,4
12762,Red Shifted,,axorion,3.00,3,0,3
12761,Count till Green,,drmazhar,2.67,5,0,5
12760,Shifted reflection,,scorpio,3.25,4,0,4
12759,Balloons...,,jnpollack,2.50,2,0,2
12758,Loopy Spiral,,jnpollack,3.00,1,0,1
12757,Prepare (paint your way) XXS,,scorpio,4.00,1,0,1
12756,Preparations 6,,drmazhar,3.00,3,0,3
12755,Track Switch,,jnpollack,3.25,3,0,3
12754,"Odd : 1 Way , Even : 2 Ways",,drmazhar,3.00,3,0,3
12753,Half Then Double,,drmazhar,3.00,3,0,3
12752,8 Conditions,,jnpollack,3.00,1,0,1
12751,Useless Red Tile,,jnpollack,2.80,3,0,3
12750,U - Turn,,drmazhar,2.20,4,0,4
12749,First of the Month,,GabrielR,2.00,6,-1,5
12748,Stack with Green,,drmazhar,2.50,4,0,4
12747,Empty Nest,,jnpollack,2.83,4,0,4
12746,Skeptic Tank,,jnpollack,3.00,3,0,3
12745,Reverse then U turn,,drmazhar,2.25,15,0,15
12744,Put Signs For your Ways (Version 22),,drmazhar,3.00,2,0,2
12743,Hidden stack,,scorpio,3.00,5,0,5
12742,Instruction (Version 3),,drmazhar,3.00,2,0,2
12741,Simpler Than It Looks,,jnpollack,3.00,2,0,2
12740,@-Cyclin,,scorpio,3.00,1,0,1
12739,Empty Stacks,,jnpollack,2.33,1,0,1
12738,Put Signs For your Ways (Version 21),,drmazhar,2.25,2,0,2
12737,Super Postion (Quantum Physics),,drmazhar,2.50,1,0,1
12736,Music Bass,,kiraro,2.33,7,-1,6
12735,Phoenix,,scorpio,3.25,4,0,4
12734,An Even Puzzle,,jnpollack,3.50,3,0,3
12733,An Odd Puzzle,,jnpollack,4.00,0,0,0
12732,The Green Divide,,jnpollack,3.00,3,0,3
12731,The Red Divide,,jnpollack,3.00,0,0,0
12730,Castle,,hanness,1.50,5,-1,4
12729,Cyclin,,scorpio,?,0,0,0
12728,Signs ,,drmazhar,3.20,5,0,5
12727,What the hack?,,kraker,1.83,16,0,16
12726,Letter T,,hanness,1.40,22,-1,21
12725,Plus,,Toast_,1.25,7,-2,5
12724,4_Square,,Toast_,1.73,5,-1,4
12723,Checkerboard,,Toast_,1.50,3,-1,2
12722,Cross 2,,Toast_,1.90,5,-1,4
12721,Stack with early turning warning,,scorpio,3.67,3,0,3
12720,Cross,,Toast_,1.86,4,0,4
12719,Shift (other direction),,kraker,?,0,0,0
12718,Shift,,kraker,?,0,0,0
12717,Archimedean Spiral II,,jnpollack,3.50,3,0,3
12716,Spiral with hidden stack,,scorpio,3.00,1,0,1
12715,Another Speed Control 8,,drmazhar,3.00,1,0,1
12714,Convergence II,,jnpollack,2.33,0,0,0
12713,Platform Descent,,jnpollack,2.78,7,0,7
12712,Up And Down,,kiusle,1.25,10,-3,7
12711,Inverted T - 2 functions,,bobbywankenobi,1.60,5,-1,4
12710,Mr. T,,bobbywankenobi,1.60,4,0,4
12709,Climb the pyramid,,bobbywankenobi,1.79,16,0,16
12708,Two Sides,,kiusle,1.23,17,-2,15
12707,Cross without endings.,,bobbywankenobi,1.60,4,0,4
12706,What a biatch!,,bobbywankenobi,2.10,7,0,7
12705,Spiral,,kiusle,1.25,7,-2,5
12704,Dropping the ball,,drmazhar,3.00,2,0,2
12703,Linked Rectangles (Version 2),,drmazhar,3.00,1,0,1
12702,Linked Rectangles,,drmazhar,3.00,3,0,3
12701,Can you count? II,,jnpollack,3.00,3,0,3
12700,Derpy Donut,,setnado,2.40,2,0,2
12699,Night reflection in the water,,scorpio,3.00,3,0,3
12698,Zero Stack (Version 5),,drmazhar,2.33,5,0,5
12697,Super Esey,,Kostosso,1.18,10,-1,9
12696,After Greens,,drmazhar,3.00,3,0,3
12695,Meandering Symmetry,,jnpollack,?,0,0,0
12694,Imposter Syndrome,,jnpollack,3.20,5,0,5
12693,Foundations,,jnpollack,3.00,3,0,3
12692,Prime Command Layout,,setnado,3.00,1,0,1
12691,Remove Signs for your Ways,,drmazhar,3.00,1,0,1
12690,"RGB,BRB,RGB,RBG,R",,drmazhar,2.50,1,0,1
12689,A few stars,,kserikba,2.50,3,0,3
12688,easy,,sem8,1.25,7,-2,5
12687,Hiiii!!,,ajayjha25,1.44,6,-3,3
12686,s,,sem8,3.00,6,-1,5
12685,Another speed control 7,,drmazhar,3.00,2,0,2
12684,Center Cut,,jnpollack,2.88,7,0,7
12683,Fixed Pinwheel,,scorpio,3.83,5,0,5
12682,Reflection + Greens Amplification,,drmazhar,3.50,1,0,1
12681,Simple Function,,Chirector,1.50,5,-2,3
12680,Broken Pinwheel,,jnpollack,3.10,9,0,9
12679,easy level,,sem8,1.92,10,0,10
12678,Something,,sem8,2.09,7,0,7
12677,Orderly Paint 2,,jnpollack,2.57,6,0,6
12676,Reverse Order,,drmazhar,3.25,3,0,3
12675,Flower Field,,scorpio,3.50,4,0,4
12674,Blue Offset Books,,jnpollack,2.80,5,0,5
12673,A Bulky Crawl Spiral,,jnpollack,2.50,7,0,7
12672,Just Count Greens,,drmazhar,3.00,4,0,4
12671,17 < 19,,jnpollack,3.29,6,0,6
12670,Reproduced,,jnpollack,3.14,6,0,6
12669,Reproducibility,,drmazhar,2.25,3,0,3
12668,Branches of Mazhar,,jnpollack,4.00,3,0,3
12667,Orderly Walk,,jnpollack,3.00,3,0,3
12666,With Ease,,setnado,2.50,5,0,5
12665,Seen This Before?,,jnpollack,2.83,5,0,5
12664,The best word,,kserikba,1.75,4,-2,2
12663,Spring 12,,drmazhar,3.00,5,0,5
12662,Copy work,,kserikba,2.40,4,0,4
12661,Origin,,drmazhar,4.00,0,0,0
12660,New Year Tree 2,,scorpio,3.50,3,0,3
12659,Recursive Rehash,,jnpollack,3.25,3,0,3
12658,Discrete Spiral,,drmazhar,3.00,3,0,3
12657,Special Reflection,,drmazhar,3.00,1,0,1
12656,Conditional Counting,,drmazhar,2.57,6,0,6
12655,Dual Path,,drmazhar,2.43,4,0,4
12654,Simple Six,,jnpollack,2.29,4,0,4
12653,Not so difficult,,kserikba,2.83,4,0,4
12652,Simple puzzle,,kserikba,2.09,12,0,12
12651,Green!,,drmazhar,3.67,2,0,2
12650,Five Fours,,drmazhar,3.40,3,0,3
12649,Put Signs For Your Ways (Version 20),,drmazhar,3.00,4,0,4
12648,Unnormal Points,,drmazhar,2.67,5,0,5
12647,unsolved,,tjwjdgjs22,2.30,9,0,9
12646,Another speed control 6,,drmazhar,3.00,3,0,3
12645,Direction Control,,drmazhar,3.40,3,0,3
12644,Reflection in Information Gahering way,,drmazhar,3.00,3,0,3
12643,Noise Reduction,,drmazhar,3.67,3,0,3
12642,RIGHT,,crystalruby,1.75,3,-1,2
12641,here we go again,,crystalruby,1.21,10,-2,8
12640,ummmmm,,crystalruby,1.31,8,-2,6
12639,slove?,,crystalruby,1.90,4,-1,3
12638,Counting the Columns,,drmazhar,3.25,4,0,4
12637,Turns at squares,,drmazhar,3.50,3,0,3
12636,"To sticky, kraker, and scorpio...",,jnpollack,3.50,1,0,1
12635,Growth the Thickness,,drmazhar,3.33,2,0,2
12634,Dog,,padre,2.50,8,0,8
12633,Cross 5,,tjwjdgjs22,1.58,10,0,10
12632,An Address Game,,jnpollack,3.67,5,0,5
12631,Keeping the Puzzle Feed Alive,,jnpollack,3.75,3,0,3
12630,3 Rectangles,,jnpollack,2.75,7,0,7
12629,Playing With stacks (Version 4),,drmazhar,2.40,11,0,11
12628,pro pro bro bro,,artemka1306,1.29,10,-3,7
12627,Spiky Crab,,jnpollack,2.63,7,0,7
12626,Fort Boyard,,artemka1306,1.25,11,-3,8
12625,Special Case of Reflection (2.1),,jnpollack,3.50,4,0,4
12624,Multi-purpose,,drmazhar,3.33,5,0,5
12623,Playing With stacks (Version 3),,drmazhar,3.00,3,0,3
12622,chess,,mor0048,1.27,11,-3,8
12621,lvl 1,,mor0048,1.27,13,-4,9
12620,Crab (Lite edition),,scorpio,2.50,7,0,7
12619,4 square,,mor0048,1.21,19,-2,17
12618,Holiday Lights,,jnpollack,2.60,5,0,5
12617,"Es, 3s, and Cs",,jnpollack,3.67,2,0,2
12616,Another Reflection control,,drmazhar,3.00,3,0,3
12615,Don‚Äôt Paint Your Puzz,,jnpollack,3.00,0,0,0
12614,Crab,,scorpio,3.75,5,0,5
12613,Lines of Mines,,jnpollack,3.50,3,0,3
12612,Meander,,inconight,2.00,1,-1,0
12611,Filter (Version 4),,drmazhar,2.80,5,0,5
12610,Not so easy,,Sewadius,1.67,8,-3,5
12609,Diamond Stack,,jnpollack,4.00,1,0,1
12608,Get Around 2,,jnpollack,3.33,5,0,5
12607,Pumpkin (Halloween special) ,,scorpio,4.00,3,0,3
12606,Get Around,,jnpollack,3.00,4,0,4
12605,Moving Cross,,drmazhar,3.25,2,0,2
12604,Checkpoint,,MasterLuk,2.71,4,0,4
12603,Half Life (Version 2),,drmazhar,2.75,3,0,3
12602,X In X,,mynwo,2.00,4,-1,3
12601,Zero Stack (Version 3),,drmazhar,2.43,4,0,4
12600,Zero Stack (Version 3),,drmazhar,2.22,8,0,8
12599,2 in 1,,kserikba,3.00,3,0,3
12598,Another Paint Stacker,,jnpollack,3.00,3,0,3
12597,Broken Columns,,jnpollack,4.00,2,0,2
12596,Red Zigs; Green Zags,,jnpollack,2.80,3,0,3
12595,a,,drmazhar,3.00,8,0,8
12594,Go forward and back,,offreal,1.54,8,-3,5
12593,Tap Your Brakes Lightly II,,drmazhar,3.50,3,0,3
12592,Black Zone,,drmazhar,3.00,2,0,2
12591,Tap Your Brakes Lightly,,jnpollack,3.25,3,0,3
12590,Red Means 4 More,,jnpollack,3.00,1,0,1
12589,Trick Stack Tutorial,,jnpollack,3.00,0,0,0
12588,Tap Your Brakes,,jnpollack,4.33,2,0,2
12587,Reflection (Version 9),,drmazhar,3.00,3,0,3
12586,Backup & Restore (Version 9) ,,drmazhar,3.00,3,0,3
12585,Noob Stack Tutorial,,jnpollack,2.50,5,0,5
12584,Tutorial:Part 2,,artemka1306,1.24,14,-3,11
12583,Tutorial:Part 1,,artemka1306,1.24,18,-3,15
12582,It,,artemka1306,1.20,10,-2,8
12581,candy,,artemka1306,1.27,10,-2,8
12580,Green spiral,,kserikba,2.63,5,0,5
12579,Thick Plus II (Stack version),,drmazhar,2.33,2,0,2
12578,Thick Plus,,jnpollack,2.33,3,0,3
12577,Directions by Reds,,drmazhar,3.00,3,0,3
12576,Comman for Different,,drmazhar,2.33,6,0,6
12575,????? (Version 2),,jnpollack,4.00,0,0,0
12574,Odds and Evens (Lite edition),,scorpio,3.00,11,0,11
12573,cosmonavt,,artemka1306,1.21,30,-2,28
12572,2+2=?,,artemka1306,1.23,29,-3,26
12571,pro vs nub!!!,,artemka1306,1.29,23,-6,17
12570,?????,,artemka1306,1.23,20,-4,16
12569,"Store,Skip and Add",,drmazhar,3.00,1,0,1
12568,A trip to the top (Part 7),,drmazhar,4.00,2,0,2
12567,Unicolor,,dstroy,1.29,10,-2,8
12566,Lots of Knots,,setnado,3.18,10,0,10
12565,Green Wall,,dstroy,2.20,7,-1,6
12564,Come back,,dstroy,1.50,5,-2,3
12563,You decide the way.,,dstroy,1.78,3,-1,2
12562,Colorful path,,dstroy,2.36,10,0,10
12561,Just an other easy puzzle.,,dstroy,1.50,5,-2,3
12560,Paul.,,dstroy,1.42,7,-1,6
12559,Crossing the cross,,dstroy,1.31,10,-2,8
12558,Triangular Release,,jnpollack,3.50,3,0,3
12557,Still a simple cross III,,drmazhar,2.20,4,0,4
12556,Still a simple cross II,,drmazhar,1.86,6,-1,5
12555,Dropping the ball,,drmazhar,2.67,2,0,2
12554,NeverSureWhatI'mDoing,,jnpollack,3.40,4,0,4
12553,Exercise for myself,,kserikba,3.00,5,0,5
12552,lvl 14. II,,drmazhar,2.67,3,0,3
12551,lvl 14.,,dstroy,1.58,8,-2,6
12550,TIC/TOC,,jnpollack,3.00,1,0,1
12549,Stack Control (Version 2),,drmazhar,2.33,5,0,5
12548,Stack Control,,drmazhar,2.57,6,0,6
12547,Cameron_ada...'s work tile 2,,kserikba,2.29,2,-2,0
12546,Interesting Tile,,kserikba,2.13,3,-1,2
12545,Septopus,,jnpollack,3.00,1,0,1
12544,OR with 2 bits,,drmazhar,3.00,2,0,2
12543,Spring 11,,drmazhar,4.00,2,0,2
12542,Experiment,,kserikba,2.00,5,-1,4
12541,5,,kserikba,1.64,5,-2,3
12540,To red and back,,kserikba,2.13,5,-1,4
12539,Green and red,,kserikba,1.85,10,0,10
12538,"very beauty, such smart, much wow",,dumbspark,2.00,2,-1,1
12537,INF2019_08,,dumbspark,2.00,1,0,1
12536,Postponed Pop (Version 2),,drmazhar,3.20,5,0,5
12535,Do you know da way?,,setnado,3.38,8,0,8
12534,"JP ("" Jared Pollack "")",,drmazhar,2.50,7,-1,6
12533,Half or double,,scorpio,5.00,1,0,1
12532,(1/2) OR (1/5),,drmazhar,3.00,6,0,6
12531,Turn at the half,,scorpio,5.00,1,0,1
12530,Gate at the half,,drmazhar,2.80,12,0,12
12529,Flying Fishy II - Respect & Humility II,,drmazhar,2.40,8,-1,7
12528,Flying Fishy II - Respect & Humility,,jnpollack,1.70,7,-3,4
12527,My First,,Hoppy_,2.00,5,-2,3
12526,S or 5,,kserikba,1.80,7,-1,6
12525,Aggregations,,drmazhar,3.00,4,0,4
12524,F1 if Blue,,jnpollack,4.00,2,0,2
12523,Reflection (Version 8),,drmazhar,3.00,3,0,3
12522,Odds and Evens,,scorpio,5.00,1,0,1
12521,Multi Another speed control (Id:192),,drmazhar,3.00,1,0,1
12520,Delta,,drmazhar,2.60,4,0,4
12519,Glass House Troll,,jnpollack,3.00,1,0,1
12518,Instruction (Version 2),,drmazhar,2.20,5,0,5
12517,Multiple stacks in one function IV,,scorpio,?,0,0,0
12516,Playing With stacks (Version 2),,drmazhar,3.00,3,0,3
12515,The Basics #5,,nathan36098,1.42,10,-4,6
12514,The Basics #4,,nathan36098,1.29,13,-3,10
12513,The Basics #3,,nathan36098,1.29,24,-3,21
12512,The Basics #2,,nathan36098,1.27,9,-2,7
12511,The Basics #1,,nathan36098,1.12,50,-9,41
12510,Aadaptation,,drmazhar,3.00,3,0,3
12509,Red Signs,,drmazhar,2.20,4,0,4
12508,Discerete Patterns,,drmazhar,2.00,3,0,3
12507,Go & Back (Version 5),,drmazhar,2.33,3,0,3
12506,Other Side,,drmazhar,2.50,4,0,4
12505,Ignore Reds,,drmazhar,1.80,0,-3,-3
12504,Crawl & Double Blue Tiles,,scorpio,4.00,1,0,1
12503,The Same with Odd & the Double with Even,,drmazhar,2.25,2,0,2
12502,"Red,Green and Green with Red",,drmazhar,2.57,5,0,5
12501,Radar (Version 3),,drmazhar,3.00,2,0,2
12500,Maximum is Three,,drmazhar,3.00,3,0,3
12499,RedFlag,,barburator,2.29,4,-1,3
12498,first,,barburator,1.45,6,-3,3
12497,Mountain,,drmazhar,3.00,3,0,3
12496,1>2>3>4>5>6>7>8,,drmazhar,3.00,3,0,3
12495,GreenWay,,barburator,1.89,5,-1,4
12494,S-BIG,,barburator,2.75,5,0,5
12493,two side,,barburator,2.50,8,-1,7
12492,Crawl & Double (4 sides),,scorpio,?,0,0,0
12491,AltTest,,barburator,1.75,6,-1,5
12490,Dual purpose (Version 4),,drmazhar,3.00,2,0,2
12489,Parallelogram (Version 2),,drmazhar,1.88,6,-1,5
12488,Interrupt (Version 4) ,,drmazhar,2.80,4,0,4
12487,Popping Control,,drmazhar,4.00,1,0,1
12486,Semi Diagonals,,drmazhar,2.00,8,-1,7
12485,Increasing Squares III,,drmazhar,3.00,3,-1,2
12484,Paint Power of 2 Generator,,jnpollack,3.75,3,0,3
12483,Increasing Crosses,,jnpollack,3.00,4,0,4
12482,Interrupt (Version 3) ,,drmazhar,3.00,2,0,2
12481,135531,,jnpollack,3.00,0,0,0
12480,snake star,,Mare,1.80,5,-2,3
12479,Go & Back (Version 4),,drmazhar,2.67,1,0,1
12478,Shape cutter,,scorpio,?,0,0,0
12477,Absolute difference,,scorpio,3.00,4,0,4
12476,Interrupt (Version 2),,drmazhar,3.00,2,0,2
12475,Breaking the System,,setnado,3.00,4,0,4
12474,Interrupt,,drmazhar,3.00,2,0,2
12473,Seismic Stack,,jnpollack,3.40,4,0,4
12472,Acid Rain,,jnpollack,3.67,5,0,5
12471,Mazharian Magic,,jnpollack,3.40,4,0,4
12470,Information Gathering 6,,drmazhar,3.50,3,0,3
12469,Systematic,,drmazhar,1.89,7,0,7
12468,Tribonacci calculation,,scorpio,?,0,0,0
12467,Zero Stack (Version 2),,drmazhar,2.75,3,0,3
12466,Easy Squares,,drmazhar,2.50,4,0,4
12465,Two changing,,drmazhar,2.25,2,0,2
12464,CHESS,,rockman,1.71,7,-3,4
12463,NANNY MC PHEE,,rockman,1.19,20,-7,13
12462,2+2,,rockman,1.31,8,-8,0
12461,1+1,,rockman ,1.58,5,-3,2
12460,Special Case of Reflection (Version 6),,drmazhar,3.50,2,0,2
12459,Star Cleanser,,jnpollack,3.50,1,0,1
12458,Fibonacci notation III,,scorpio,?,0,0,0
12457,Pushing up the base.,,drmazhar,2.29,4,0,4
12456,Fibonacci calculation,,scorpio,?,0,0,0
12455,Pitchfork Spiral,,jnpollack,3.50,1,0,1
12454,"Beyond Vulgar, Offensive, & Obnoxious",,jnpollack,3.67,0,-1,-1
12453,Special Spiral (Version 4),,drmazhar,2.00,4,0,4
12452,"Vulgar, Offensive, and Obnoxious",,jnpollack,3.00,0,0,0
12451,Assembling,,drmazhar,3.75,3,0,3
12450,End at Begining,,drmazhar,3.33,2,0,2
12449,Magnificent 7,,jnpollack,3.67,1,0,1
12448,big red X 2 III,,drmazhar,3.00,2,0,2
12447,big red X 2 II,,drmazhar,3.67,2,0,2
12446,Disarticulated,,axorion,3.00,0,0,0
12445,Behind Bars,,jnpollack,3.00,0,0,0
12444,RightUpPaint,,jnpollack,3.20,3,0,3
12443,C-Clamps,,jnpollack,3.00,1,0,1
12442,Optimum Iteration,,axorion,3.00,1,0,1
12441,Pyramid's property,,drmazhar,3.50,2,0,2
12440,Go & Back (Version 3),,drmazhar,3.00,3,0,3
12439,BOTSPORT,,jnpollack,3.00,2,0,2
12438,BOGO,,axorion,3.50,2,0,2
12437,Discrete Spiral,,drmazhar,2.50,3,0,3
12436,Stacking for Simpletons...,,jnpollack,2.63,4,-1,3
12435,Candlestick,,drmazhar,3.00,4,0,4
12434,Outside In,,jnpollack,2.40,4,0,4
12433,Atomic Orbital II,,jnpollack,4.00,0,0,0
12432,Constant Height,,drmazhar,3.00,5,0,5
12431,Atomic Orbital,,jnpollack,3.33,1,0,1
12430,People Will See,,jnpollack,3.00,0,0,0
12429,Matching Right Hand,,drmazhar,4.00,3,0,3
12428,Interference,,scorpio,4.00,1,0,1
12427,WARNING: Ambiguous Path | Extra Slots,,jnpollack,2.33,0,0,0
12425,Just a Drop,,jnpollack,3.00,0,0,0
12424,Space Invader II,,jnpollack,4.00,0,0,0
12423,very easy,,jjjddd,1.44,12,-7,5
12422,Preparations 5,,drmazhar,3.00,3,0,3
12421,Derpy 2.0,,setnado,3.00,3,0,3
12420,Tangled Spiral,,jnpollack,3.00,4,0,4
12419,Level 1,,Charlie4285,1.09,80,-16,64
12418,Dual purpose (Version 3),,drmazhar,3.50,3,0,3
12417,Zero Stack,,drmazhar,2.29,4,0,4
12416,Re-arrangement,,drmazhar,4.50,1,0,1
12415,Binary turning,,scorpio,?,0,0,0
12414,P,,lordofdead38,1.44,9,-2,7
12413,The ADHD Bot,,jnpollack,4.00,0,0,0
12412,Playing With Stacks,,drmazhar,4.00,1,0,1
12411,Simply Simple,,axorion,3.00,1,-1,0
12410,Special Spiral (Version 3),,drmazhar,2.80,3,0,3
12409,5>4>3>2>1,,drmazhar,2.30,8,0,8
12408,Discrete Distances.,,drmazhar,2.60,3,0,3
12407,Psych Out,,axorion,?,0,0,0
12406,Discrete Increasing,,drmazhar,2.75,3,0,3
12405,Discrete Reflection,,drmazhar,3.60,3,0,3
12404,One quarter of the information (Lite edition),,scorpio,3.75,4,0,4
12403,One quarter of the information,,scorpio,5.00,2,0,2
12402,Human Body,,drmazhar,3.00,3,0,3
12401,One way ticket (Lite edition),,scorpio,2.86,6,0,6
12400,Stampy's face !,,Cico,1.46,3,-4,-1
12399,Exponential Growth II,,jnpollack,3.50,1,0,1
12398,One way ticket,,scorpio,4.00,2,0,2
12397,Ducky !!!!!!!!!!!!!!!!!!,,Cico,1.14,56,-22,34
12396,Dimand Minecraft wand,,Cico,1.26,10,-6,4
12395,lava!,,Cico,1.33,21,-8,13
12394,Rain!,,Cico,2.00,4,-2,2
12393,Rain,,Cico,1.17,25,-4,21
12392,Josephus problem 4,,drmazhar,3.00,1,0,1
12391,Josephus problem 3,,drmazhar,3.00,0,0,0
12390,Flying Fishy,,Cico,1.47,8,-4,4
12389,Bus ,,Cico,1.33,19,-7,12
12388,c0nfus10N,,Cico,1.44,6,-5,1
12387,Redshift II,,scorpio,3.00,2,0,2
12386,Blue-Green Inversion,,scorpio,3.00,2,0,2
12385,Nossa foi dificil fazer este ,,12345joao,1.64,3,-3,0
12384,"""2X"" Or ""X+1""",,drmazhar,2.63,9,0,9
12383,Redshift,,scorpio,3.00,2,0,2
12382,Clean your ways ( Version 2),,drmazhar,3.33,2,0,2
12381,Starch,,jnpollack,2.33,1,0,1
12380,Fountain,,scorpio,2.67,3,0,3
12379,Access Point III,,scorpio,2.60,5,0,5
12378,Clean your ways,,drmazhar,2.60,4,0,4
12377,Road Map (Version 3),,drmazhar,2.75,4,0,4
12376,Access Point II,,scorpio,3.00,2,0,2
12375,Access Point,,axorion,3.25,4,0,4
12374,Three Stages,,drmazhar,2.50,4,0,4
12373,Replication Engine 15,,drmazhar,2.33,4,0,4
12372,Decision by Comparision,,drmazhar,2.25,3,0,3
12371,Boomerang,,axorion,3.00,1,0,1
12370,Ratchet,,axorion,3.00,2,0,2
12369,Preparations XXS,,scorpio,4.00,2,0,2
12368,Preparations III,,drmazhar,2.33,11,0,11
12367,As Expected,,drmazhar,2.00,3,0,3
12366,Blow a spiral,,scorpio,3.00,3,0,3
12365,From Spiral to Rectangle,,drmazhar,4.00,2,0,2
12364,From Spiral to Solid Rectangle,,drmazhar,2.00,3,-2,1
12363,Early dead end alerts,,scorpio,3.00,2,0,2
12362,Accumulation,,drmazhar,3.75,3,0,3
12361,The Change,,drmazhar,4.00,2,0,2
12360,Memorizing the next turn,,scorpio,3.50,2,0,2
12359,Put Signs For Your Ways (Version 19),,drmazhar,3.75,3,0,3
12358,Three spirals,,scorpio,4.00,4,0,4
12357,Feast or Famine,,axorion,3.25,3,0,3
12356,Regular Quadrilaterals 2,,axorion,3.50,4,0,4
12355,Preparations II,,drmazhar,3.00,3,0,3
12354,Regular Quadrilaterals,,axorion,3.67,3,0,3
12353,Squares,,drmazhar,2.33,5,0,5
12352,Put signs for your Ways (Version 18),,drmazhar,2.25,4,0,4
12351,Put Signs for you Ways (Version 17) ,,drmazhar,2.50,3,0,3
12350,Put Signs For Your Ways (Version 16),,drmazhar,3.50,2,0,2
12349,Delayed Reflection,,jnpollack,3.75,3,0,3
12348,Red lines 2,,jnpollack,2.10,6,-1,5
12347,Radar ( Version 1),,drmazhar,3.25,4,0,4
12346,Radar,,drmazhar,2.80,3,0,3
12345,The Black Hole,,drmazhar,2.00,2,0,2
12344,The Runaround,,axorion,3.00,4,0,4
12343,Boxed Lunch,,jnpollack,4.00,0,0,0
12342,Ivy,,axorion,3.25,4,0,4
12341,Stage Board,,drmazhar,2.80,4,0,4
12340,A Light Snack,,jnpollack,2.83,4,0,4
12339,YYY,,drmazhar,3.00,2,0,2
12338,Some thing from Spring,,drmazhar,3.00,2,0,2
12337,Half blind spiral,,scorpio,3.67,3,0,3
12336,Green to blue spiral,,scorpio,4.00,1,0,1
11336,"Oh no, this is the road to hell (ver.2)",,scorpio,4.00,2,0,2
11335,Copy of a blue way,,scorpio,3.50,3,0,3
11334,Flip Flop Drip Drop (DC1),,jnpollack,3.00,0,0,0
11333,Only Even Reds,,drmazhar,3.00,2,0,2
11332,Go & Back (Version 2),,drmazhar,4.00,1,0,1
11331,Go & Back,,drmazhar,2.25,3,0,3
11330,Hard Condition,,drmazhar,2.00,1,0,1
11329,The Difference,,drmazhar,3.50,1,0,1
11328,Copy of the blue mask,,scorpio,4.00,1,0,1
11327,Circuit construction,,scorpio,4.00,1,0,1
11326,Free Pancakes,,jnpollack,3.00,2,0,2
11325,Cutting Corners,,axorion,3.00,1,0,1
11324,Minefield Pro,,scorpio,?,0,0,0
11323,puzzle impossible,,ajayjha25,1.26,13,-5,8
11322,Disintegration,,jnpollack,4.00,0,0,0
11320,STARS!!!!!!!!!!!!!!!,,imjha,1.26,10,-6,4
11319,Hierarchy II,,jnpollack,3.50,5,0,5
11318,Increasing,,drmazhar,3.00,1,0,1
11317,Decreasing,,drmazhar,3.00,2,0,2
11316,Stars are on the left.,,jnpollack,2.60,3,0,3
11315,Cutting Corners,,jnpollack,4.00,1,0,1
11314,Spaghetti Legs,,jnpollack,3.50,2,0,2
11313,Length comparison,,scorpio,4.25,4,0,4
11312,Comparision,,drmazhar,3.00,5,0,5
11311,gun,,badurls,1.53,8,-4,4
11310,dinosaur,,badurls,1.33,8,-5,3
11309,Green Forward Green (Version 3),,drmazhar,2.67,1,0,1
11308,Holy Apple,,jnpollack,2.00,1,0,1
11307,Green Forward Green (Version 2),,drmazhar,2.40,4,0,4
11306,Green forward Green,,drmazhar,2.80,4,0,4
11305,Second green,,scorpio,3.80,5,0,5
11304,Simpler Patterns,,jnpollack,2.57,4,0,4
11303,7 steps,,scorpio,4.00,4,0,4
11302,Three Instructions,,drmazhar,2.75,3,0,3
11301,Copy then paste (Version 5) ,,drmazhar,3.00,2,0,2
11300,Drunken stack 4,,qinn,3.50,2,0,2
11299,Shortened spiral,,scorpio,4.00,5,0,5
11298,Double Counting (Version 3),,drmazhar,3.00,3,0,3
11297,Copy then Paste (Version 4) ,,drmazhar,3.25,4,0,4
11296,Blue figure copy,,scorpio,4.00,2,0,2
11295,Training Day Extract,,jnpollack,3.38,8,0,8
11294,Black cat copy,,scorpio,3.33,3,0,3
11293,Stars splitting,,scorpio,4.00,2,0,2
11292,Something Common,,drmazhar,3.50,4,0,4
11291,Broken square II,,scorpio,3.50,2,0,2
11290,Sampler Platter,,jnpollack,4.00,0,0,0
11289,fase,,badurls,1.35,8,-5,3
11288,???????,,badurls,1.92,7,-1,6
11287,?? ????,,StepovoyVlad,1.29,5,-4,1
11286,Tracks,,drmazhar,3.14,6,0,6
11285,Chalk,,jnpollack,3.00,3,0,3
11284,Some Correction,,drmazhar,2.22,6,0,6
11283,Some Changing,,drmazhar,2.50,12,0,12
11282,Growing tree,,scorpio,4.00,3,0,3
11281,Special Case of Reflection (Version 5),,drmazhar,3.20,4,0,4
11280,Dispersion (Version 7),,drmazhar,2.33,4,0,4
11279,Square Growth II,,jnpollack,4.00,0,0,0
11278,Complete,,drmazhar,3.00,5,0,5
11277,Complete Coverage,,jnpollack,3.00,3,0,3
11276,Warm-up X,,jnpollack,3.00,4,0,4
11275,Selection,,drmazhar,2.80,3,0,3
11274,Matching The Triangles,,drmazhar,2.33,2,0,2
11273,Weedless,,codeKameleon,1.42,7,-2,5
11272,Mr Blue,,codeKameleon,1.82,7,0,7
11271,Impawssible,,codeKameleon,1.72,20,0,20
11270,Dual purpose (Version 2),,drmazhar,2.56,11,0,11
11269,19,,codeKameleon,1.67,5,-2,3
11268,!trafficLaws,,codeKameleon,1.38,6,-4,2
11267,Langton's 2:1 Ant,,jnpollack,2.75,1,0,1
11266,Double Red Dead End,,jnpollack,3.08,13,0,13
11265,Line to spiral (uncentered spring),,scorpio,3.00,3,0,3
11264,Addresses (Version 2),,drmazhar,3.00,4,0,4
11263,Addresses,,drmazhar,3.20,5,0,5
11262,rgb allstars,,codeKameleon,1.62,7,-1,6
11261,Robin,,codeKameleon,2.14,14,0,14
11260,Bloody Middle,,codeKameleon,1.44,7,-3,4
11259,Donnie Splatoon,,codeKameleon,1.33,11,-2,9
11258,42 - 3,,codeKameleon,1.53,7,-3,4
11257,harder puzzle,,MathiasLipko,1.62,8,-1,7
11256,Red inside blue,,aja2718,2.33,4,-1,3
11255,"Five Sevens ""77777""",,drmazhar,2.75,3,0,3
11254,Reflection III,,drmazhar,3.00,3,0,3
11253,Cycle to spiral,,scorpio,4.00,1,0,1
11252,Replication Engine 14,,drmazhar,3.50,4,0,4
11251,Delay while Pushing and Poping,,drmazhar,2.33,2,0,2
11250,Painting delay,,scorpio,2.69,14,0,14
11249,Floors & Distances,,drmazhar,3.00,1,0,1
11248,Down and up (Version 2),,drmazhar,2.50,3,0,3
11247,Down then Up,,drmazhar,2.50,14,0,14
11246,Get the address (Version 13),,drmazhar,3.33,3,0,3
11245,Animals Fight for a Treat,,jnpollack,3.67,2,0,2
11244,Multiple stacks in one function (Lite edition),,scorpio,3.57,6,0,6
11243,Multiple stacks in one function III,,scorpio,4.00,3,0,3
11242,Double Counting (Version 2),,drmazhar,3.50,1,0,1
11241,Exceeded Quota,,jnpollack,3.20,4,0,4
11240,Multiple stacks in one function II,,scorpio,4.00,2,0,2
11239,Twisted Hourglass,,jnpollack,3.25,3,0,3
11238,Inchworm on a Stick,,jnpollack,3.00,1,0,1
11237,A Hint Perhaps,,jnpollack,?,0,0,0
11236,Hierarchy,,jnpollack,3.50,3,0,3
11235,"Welcome Back, Smylic!",,jnpollack,?,0,0,0
11234,Multiple stacks in one function,,scorpio,4.33,3,0,3
11233,Order of Operations,,axorion,3.00,5,0,5
11232,Choose your turn II,,scorpio,3.50,3,0,3
11231,Overlapping Hs,,jnpollack,3.00,0,0,0
11230,Catch the colour ( Version 2 ),,drmazhar,2.60,1,0,1
11229,Copy then Paste (Version 3) ,,drmazhar,2.14,6,-1,5
11228,Perimeter Stations 3,,jnpollack,4.25,1,0,1
11227,Perimeter Stations 2,,jnpollack,2.17,0,-2,-2
11226,Perimeter Stations 1,,jnpollack,1.92,4,-2,2
11225,Divisible by 1 or 2 or 3,,drmazhar,2.75,3,0,3
11224,Accumulation,,axorion,4.00,4,0,4
11223,Scales of Justice (Version 2),,drmazhar,2.13,7,-1,6
11222,2019 (Happy New Year),,drmazhar,3.75,3,0,3
11221,New Year Tree,,scorpio,2.50,3,-1,2
11220,Snowflake coloration III,,scorpio,4.00,1,0,1
11219,This One Goes to 11.,,setnado,2.50,5,0,5
11218,Snowflake coloration II,,scorpio,3.00,5,0,5
11217,Snowflake coloration,,scorpio,3.00,1,0,1
11216,Paint the Snowflake,,jnpollack,2.13,4,-1,3
11215,Moving Green,,drmazhar,3.00,1,0,1
11214,Scales of Justice,,scorpio,3.75,3,0,3
11213,The Justice,,drmazhar,3.50,2,0,2
11212,Passing the Torch,,jnpollack,3.50,1,0,1
11211,Rectangles construction,,scorpio,?,0,0,0
11210,Fill ice rinks II,,scorpio,3.00,2,0,2
11209,Fill ice rinks,,scorpio,3.00,1,0,1
11208,Crawl and Fall 2,,jnpollack,2.50,4,0,4
11202,Octagram,,axorion,?,0,0,0
11201,the shadow,,drmazhar,2.86,5,0,5
11200,Crawl and Fall,,jnpollack,2.83,4,0,4
11199,kind of Towers,,drmazhar,2.25,2,0,2
11198,Grinch Star,,jnpollack,3.00,0,0,0
11197,Christmas Wreath,,axorion,3.00,1,0,1
11196,Linked list 9,,drmazhar,3.50,2,0,2
11195,ZigZag Counting,,drmazhar,2.67,9,0,9
11194,Abnormal,,drmazhar,3.00,1,0,1
11193,Sum of Greens,,drmazhar,2.12,7,-1,6
11192,Puzzle #1,,jdicarlo,1.46,8,-4,4
11191,Extreme Expansion,,aja2718,4.00,1,-1,0
11184,Diamond Growth,,aja2718,2.60,2,-1,1
11183,Colour Separtion (Version 2),,drmazhar,3.00,2,0,2
11182,Colour Separation,,drmazhar,4.00,1,0,1
11181,Small Square = Small Solution,,aja2718,2.08,7,-1,6
11180,Big Wheel,,axorion,3.00,1,0,1
11179,Upsizing Engine (Version 10),,drmazhar,3.00,5,0,5
11178,Octagonal Wheel 2,,aja2718,2.00,3,-1,2
11177,Beachcombing,,axorion,3.33,12,0,12
11176,Thick stack,,scorpio,3.00,4,0,4
11175,Octagonal Wheel,,aja2718,2.56,7,-1,6
11174,hard stack,,neenthewiser,1.71,8,-2,6
11173,Map of Greens & Blues,,drmazhar,2.67,2,0,2
11172,753 got hacked,,jnpollack,3.00,0,0,0
11171,Bloodlust,,aja2718,2.22,5,-1,4
11170,Filter (Version 3),,drmazhar,1.67,6,-2,4
11169,Tree with red ends,,scorpio,3.40,5,0,5
11168,Waterfalls III,,scorpio,5.00,2,0,2
11167,Waterfalls II,,scorpio,4.00,3,0,3
11166,Another Reflection control,,drmazhar,3.33,2,0,2
11165,simple stack 2,,neenthewiser,1.67,8,-1,7
11164,simple stack 3,,neenthewiser,1.50,6,-6,0
11163,Ternary tree,,scorpio,2.88,19,0,19
11162,RGBF3,,axorion,3.50,3,0,3
11161,The Guide (Version 5),,drmazhar,2.83,5,0,5
11160,Linked List 8,,drmazhar,3.67,2,0,2
11159,Ternary tree copy II,,scorpio,5.00,1,0,1
11158,Ternary tree copy,,scorpio,4.00,1,0,1
11157,Half Baked,,axorion,2.33,5,0,5
11156,Designing a puzzle,,NeddlesKing,1.64,7,-3,4
11155,Simple Stack 1,,neenthewiser,1.73,8,-3,5
11154,Good Will,,axorion,4.00,0,0,0
11153,Attraction and Repulsion,,aja2718,4.00,3,-1,2
11152,Incomprehensible,,axorion,3.50,1,0,1
11151,Stranger Than Stranger Than The Strangest Shape,,aja2718,4.00,1,0,1
11150,Stranger Than the Strangest Shape,,aja2718,4.00,1,0,1
11149,Karma,,axorion,4.00,0,0,0
11148,Just a relaxing little thing,,aja2718,1.62,7,-3,4
11147,5K Club's Newest Member,,jnpollack,?,0,0,0
11146,Cross Wiggling,,aja2718,1.90,8,-2,6
11145,The Strangest Shape,,aja2718,4.00,1,0,1
11144,Catch the color,,drmazhar,2.20,8,0,8
11143,stack then bruteforce,,neenthewiser,2.00,6,-1,5
11142,Core,,axorion,3.00,1,0,1
11141,Filling a square,,scorpio,4.50,2,0,2
11140,puzzle no.3 ENGR 100 II,,drmazhar,3.00,3,0,3
11139,Linked list 7,,drmazhar,3.75,4,0,4
11138,Half on reverse,,drmazhar,3.00,1,0,1
11137,Triple Threat,,axorion,?,0,0,0
11136,Primed For Failure,,axorion,4.00,1,0,1
11135,Infinity Carat,,scorpio,?,0,0,0
11134,Cubic Zirconia Unlimited,,scorpio,?,0,0,0
11133,Polished Gravel,,axorion,3.00,2,0,2
11132,Forever Trunk,,ZorkonZorba ,1.33,10,-5,5
11131,Two and One,,aja2718,3.25,3,0,3
11130,ENGR 100 the 5TH,,yash7,1.38,5,-4,1
11129,Combination Puzzle,,AynaJain,1.30,27,-11,16
11128,Cubic Zirconia II,,drmazhar,3.00,2,0,2
11127,*SELECTION*,,robozzle01,1.50,6,-4,2
11126,Spiral-ly II,,drmazhar,2.09,6,0,6
11125,Let let let us in - like a salad bowl,,ENGR1002345,2.40,3,-1,2
11124,This is Iteration,,AynaJain,1.26,12,-7,5
11123,This is Selection,,AynaJain,1.62,3,-5,-2
11122,hola,,itnaspecific,1.33,6,-4,2
11121,puzzle 4th ENGR 100,,yash7,1.25,10,-5,5
11120,Simple Selection,,ENGR1002345,1.73,5,-4,1
11119,GO AROUND,,AynaJain,1.54,6,-3,3
11118,puzzle no.3 ENGR 100,,yash7,1.42,5,-6,-1
11117,2nd puzzle ENGR 100,,yash7,1.24,11,-6,5
11116,puzzle 1 ENGR100,,yash7,1.14,92,-25,67
11115,Yes - Use All Spaces,,ENGR1002345,1.60,3,-3,0
11114,The Swap,,CandyApples,1.50,5,-4,1
11113,What does DNA stand for?,,ENGR1002345,1.64,3,-5,-2
11112,Hacked! Hacked! (A Tired Act),,jnpollack,?,0,0,0
11111,11111,,scorpio,3.60,4,0,4
11110,why be a king when you could be god,,itnaspecific,1.39,14,-8,6
11108,ab ye karke dekhao,,itnaspecific,1.89,4,-3,1
11107,BoxToBox,,TeriMaaKa,1.36,19,-5,14
11106,WOW,,terimaaka,1.45,6,-3,3
11105,2.Iteration(UIC),,iMxM7,1.50,5,-6,-1
11104,Selection AS,,engr100project,1.26,13,-6,7
11103,Spiral-ly,,KrustyCrew,1.54,7,-5,2
11102,3.Function calls(UIC),,iMxM7,1.78,3,-2,1
11101,Up and Around,,gamers69,2.14,5,-1,4
11100,Paste,,axorion,3.80,4,0,4
11099,Cubic Zirconia,,axorion,4.00,4,0,4
11098,Walk the Halls,,fesp2018fall,2.00,6,-1,5
11096,Switch Iteration,,KrustyCrew,1.31,7,-5,2
11084,Ring,,uiccs2018,1.18,20,-11,9
11083,easy for beginners,,itnaspecific,1.69,4,-6,-2
11082,Iteration Tangled,,zjsengr100,1.50,5,-5,0
11081,S,,terimaaka,1.58,8,-2,6
11080,Selection e,,zjsengr100,1.80,5,-3,2
11079,YMCA,,RubberDucky,2.00,5,-2,3
11078,Selection Worm,,RubberDucky,1.78,4,-4,0
11077,Function Cinnamon Bun,,zjsengr100,1.55,5,-5,0
11076,Combination 2,,zjsengr100,2.71,4,-1,3
11075,engrrr 100,,robozzled9000,1.20,22,-7,15
11074,Mario,,zjsengr100,1.17,20,-10,10
11073,4,,iMxM7,2.11,5,-1,4
11072,Iteration,,groupproject_1,1.43,5,-5,0
11071,Zig Zag YOYO,,RubberDucky,1.62,6,-3,3
11069,Green Loops,,RubberDucky,2.33,5,-1,4
11068,Crossroads,,RubberDucky,1.46,7,-4,3
11067,Slalom,,robozzled9000,1.58,5,-3,2
11066,3. fucntion call,,imxm7,2.00,13,0,13
11065,When to turn?,,fesp2018fall,1.80,3,-5,-2
11064,1.Selection(UIC),,iMxM7,1.24,12,-7,5
11063,Iteration+Function Call,,ENGR1002345,1.50,5,-5,0
11062,Selection(engr100),,robozzled9000,3.50,5,-1,4
11061,Paperclip,,uiccs2018,1.28,8,-9,-1
11059,Iteration 1000,,robozzled9000,1.23,35,-20,15
11058,Confusing Roads,,fesp2018fall,3.00,2,0,2
11057,Selection,,SAA100,1.57,3,-5,-2
11056,Function call+selection,,SAA100,2.75,2,-1,1
11055,UIC_ENGR_100,,KrustyCrew,1.32,14,-8,6
11054,candy apple ,,CandyApples,2.00,4,-2,2
11053,Function Call,,ZorkonZorba,1.82,6,-1,5
11052,Swan ,,uicejj,2.20,6,-2,4
11051,Five Carat,,axorion,3.50,4,0,4
11050,Snake ,,uicejj,1.42,4,-5,-1
11049,Loop ,,UicEJJ,1.89,6,-1,5
11048,Selection and Iteration,,gamers69,1.50,6,-3,3
11047,iteration and selection,,uiceng100,1.24,12,-5,7
11046,Ryabko,,dmmn,1.88,5,-1,4
11045,Selection Puzzle,,dmmn,1.33,6,-6,0
11044,Iteration,,gamers69,1.67,3,-2,1
11043,ENGR 100 Selection,,gamers69,3.20,4,0,4
11042,selection and function calling,,uiceng100,1.80,3,-5,-2
11041,Red and green,,psef2018,1.86,3,-2,1
11040,Complex Problem,,dmmn,1.86,2,-2,0
11039,Iteration (with some function calls),,fespbois,1.58,3,-4,-1
11038,Iteratingz,,psef2018,1.29,11,-6,5
11036,Selection,,psef2018,1.78,5,-1,4
11035,FESP Iteration,,ZorkonZorba,2.50,1,-1,0
11034,Challenge 1 v2,,groupproject_1,1.75,3,-3,0
11033,WayToPlus,,TeriMaaKa,1.89,5,-2,3
11032,Ayy yuh,,dmmn,1.73,7,-1,6
11031,GreenBoxRedBox,,TeriMaaKa,1.92,5,-1,4
11030,Bridge over water,,uiccs2018,1.73,5,-2,3
11029,EZ recursive function,,fesp2018fall,1.64,8,-3,5
11028,Mountain,,csproject20,1.91,4,-2,2
11027,EZ iteration,,fesp2018fall,1.33,9,-6,3
11026,Function calls,,fespbois,2.00,4,-2,2
11025,V and around square,,Quotas,2.29,5,-1,4
11024,"""Significant"" challenge",,dmmn,2.00,12,0,12
11023,Stream,,UICejj,1.71,3,-1,2
11022,Squares,,CS_Team,2.00,5,-1,4
11021,Iteration,,cs_team,1.70,6,-3,3
11020,4 Corners with a Question,,admwuic,2.00,6,-1,5
11019,Combo: Function and Selection,,admwuic,2.17,1,-1,0
11018,Selection,,FESP200,1.33,8,-2,6
11017,Function Call,,admwuic,1.88,4,-2,2
11016,Selection & Iteration,,cs_team,1.25,20,-6,14
11015,Selection,,admwuic,1.60,5,-3,2
11014,colorful_track,,gootipapa,2.40,4,-1,3
11013,Pretty Simple,,CandyApples,1.54,6,-3,3
11012,Pesky holes,,SAA100,3.00,1,-1,0
11011,Looper,,admwuic,1.91,6,-1,5
11010,Fun_mania,,cs_team,1.19,53,-7,46
11009,Ship,,CS_Team,1.90,3,-3,0
11007,Do It Right,,aja2718,3.00,5,-1,4
11006,Mirror_Image_Sort_of,,RaphDevaTaeh,1.80,4,-2,2
11004,UIC_ENGR_100,,KrustyCrew,1.62,8,-3,5
11003,Color turn selection,,fespBois,2.40,7,0,7
11002,Stack & Sweep,,axorion,3.50,2,0,2
11001,Spiral Stairs,,FESP200,2.30,3,-1,2
11000,Color Selection,,fespBois,1.19,17,-8,9
10999,Conditions,,fespBois,1.75,4,-2,2
10998,Turn the L,,UIC4,1.46,8,-3,5
10997,Color Select,,UIC4,1.41,11,-6,5
10996,function calls,,uiceng100,1.50,6,-5,1
10994,selection,,uiceng100,1.54,5,-4,1
10993,Delayed Reaction,,candyapples,1.89,4,-1,3
10992,Blue Pac-Man,,CandyApples,1.67,11,0,11
10991,Follow the trail,,ZorkonZorba,1.71,2,-3,-1
10990,"Selection, Iteration, and Function calls!",,ZorkonZorba,1.75,4,-1,3
10989,Funksions,,WASFaccount,1.88,4,-1,3
10988,Replication Engine 13,,drmazhar,3.33,2,0,2
10987,Around the ddge,,WASFaccount,1.50,4,-3,1
10986,Stacknester,,jnpollack,3.17,4,0,4
10985,Iteration + Function Calls + Selection,,fespBois,1.90,5,-2,3
10984,Selection + Function Calls,,fespBois,2.25,6,-1,5
10983,Stairway to...,,psef2018,1.24,9,-3,6
10981,Iteration,,KSJBJKNN,3.00,3,0,3
10980,SELECTION,,uiceng100,1.18,37,-20,17
10979,Selection,,KSJBJKNN,2.50,2,-3,-1
10976,Woot,,WASFaccount,1.90,6,-1,5
10975,Function Calls & Loops,,j3s1,1.75,4,-3,1
10974,ITERATION,,WASFaccount,1.26,10,-4,6
10973,function and iteration,,Potato2_0,1.23,49,-7,42
10972,Drifting,,ashkaypao,2.14,4,-2,2
10971,Challenge 1,,groupproject_1,1.60,6,-2,4
10970,selection,,Potato2_0,1.24,23,-13,10
10969,More Complex,,SAA100,2.50,3,-1,2
10968,function and selection,,Potato2_0,1.25,13,-6,7
10967,function,,Potato2_0,1.34,48,-12,36
10966,Function,,groupproject_1,1.50,7,-4,3
10965,Weird Calls,,UIC4,1.23,22,-7,15
10964,CS-111 - Combo,,groupproject_1,1.38,5,-5,0
10963,iteration,,Potato2_0,1.70,4,-4,0
10962,A combination of selection and functions,,groupproject_1,2.00,4,-4,0
10961,<PLAINTEXT>,,ayylmao,1.26,10,-8,2
10960,Call It Right,,ashkaypao,2.00,2,-3,-1
10959,A focus on selection,,groupproject_1,1.26,11,-10,1
10958,In and Out,,uiccs2018,1.78,4,-4,0
10957,Kebob,,uiccs2018,2.22,4,0,4
10951,Challenge Puzzle,,ashkaypao,1.60,2,-4,-2
10950,Function,,ashkaypao,1.88,5,-1,4
10949,Stop and Go,,gootipapa,2.83,4,0,4
10948,Iteration,,ashkaypao,1.58,6,-3,3
10947,Combo Puzzle,,FESP200,1.33,6,-6,0
10946,Weird Pathway,,WASFaccount,1.55,4,-3,1
10945,tower,,gootipapa,3.00,2,-1,1
10944,smiley face,,gootipapa,1.91,4,-2,2
10943,Green problem,,uic4,1.44,8,-6,2
10942,red star,,uic4,1.78,5,-2,3
10941,Athalia,,Dancingpotato,1.29,8,-4,4
10940,one more,,Dancingpotato,1.25,18,-7,11
10939,kobe,,Dancingpotato,1.17,41,-7,34
10938,sky,,Dancingpotato,1.30,13,-6,7
10937,eve,,Dancingpotato,1.13,26,-15,11
10936,Loop de Function,,CS_ENGR100,2.00,4,-2,2
10935,Turn and Turn,,CS_ENGR100,1.43,15,-5,10
10934,Combo,,CS_ENGR100,2.11,6,0,6
10933,Fun Function,,KMFS100,1.58,7,-2,5
10932,Figure 8,,csproject20,1.46,5,-4,1
10931,R stands for reverse,,fespkv,1.33,8,-6,2
10930,back and forth,,fespkv,1.24,20,-9,11
10929,When will you turn left?,,drmazhar,2.11,4,0,4
10928,Iteration and function calls,,robozzle01,1.89,5,-1,4
10927,Pyramid Scheme,,FESPKV,1.31,10,-5,5
10926,Look for the Maximum,,drmazhar,3.67,2,0,2
10925,Look for the Minmum,,drmazhar,3.00,2,0,2
10924,Rejected ,,aja2718,2.00,9,-1,8
10923,Iteration,,SAA100,2.10,4,0,4
10922,Turns,,CS_ENGR100,2.11,5,0,5
10921,Select Wisely,,csproject20,1.47,11,-5,6
10920,Turn right on stars IV,,jnpollack,4.00,0,0,0
10919,How????,,aja2718,3.29,4,-1,3
10918,"Cross, Don't Color, Center (REVISED)",,aja2718,3.00,2,-1,1
10917,"Cross, Don't Color, Center",,aja2718,3.20,4,-1,3
10916,Divided Highway,,axorion,3.00,2,0,2
10915,Another one,,dogWithnoLegs,1.75,6,-1,5
10914,AdamT#2,,dogWithnoLegs,1.92,7,-1,6
10913,"Cross, Color, Center",,aja2718,2.83,4,-1,3
10912,"Cross, Color, Center",,aja2718,3.00,4,-1,3
10911,Insect,,FESPKV,1.88,2,-3,-1
10910,Iterations,,FESPKV,2.50,3,-1,2
10909,*function calls*,,robozzle01,1.16,48,-12,36
10908,"Add One, Multiply By Two",,aja2718,1.80,5,-3,2
10907,Selection,,psef2018,1.31,7,-4,3
10906,Multiply by 2,,aja2718,1.60,6,-1,5
10905,simple_snake_possible_combo,,KMFS100,1.25,8,-3,5
10904,Combo,,KMFS100,1.25,13,-8,5
10903,Iteration stairs,,j3s1,1.86,2,0,2
10902,Function Calls,,KrustyCrew,1.80,8,0,8
10901,Find the Relationship,,aja2718,2.33,5,-1,4
10900,Looks Simple II,,aja2718,2.09,6,-1,5
10899,Looks Simple,,aja2718,2.09,6,-1,5
10898,Key_FunctionCalls,,RaphDevaTaeh,1.88,4,-1,3
10897,Function and Selection,,j3s1,1.45,5,-3,2
10896,Easy Peasy,,CS_ENGR100,2.00,4,-1,3
10895,One Loop Puzzle,,robozzle01,1.15,86,-11,75
10894,Square transformation,,scorpio,?,0,0,0
10893,A-MAZE-ing,,aja2718,1.83,6,-3,3
10892,ENGR 100,,dogWithnoLegs,1.22,30,-7,23
10891,Area of Square II,,scorpio,3.67,4,0,4
10890,Copy of square,,scorpio,3.67,4,0,4
10889,Merry Go Round,,FESP200,1.81,12,0,12
10888,AdamT#1,,dogWithnoLegs,1.36,7,-5,2
10887,Wiggle Room,,aja2718,2.56,5,-1,4
10886,Loop on NightyMoon,,FESP2018,2.50,9,0,9
10881,On Your Own,,aja2718,2.50,2,-1,1
10880,On Your Own ,,aja2718,3.00,2,0,2
10879,Taeho's Cool,,RaphDevaTaeh,1.75,5,-1,4
10878,Professional Janitor,,axorion,3.33,3,0,3
10877,Raphael Sucks,,RaphDevaTaeh,1.67,5,-3,2
10876,Devansh Sucks,,RaphDevaTaeh,1.42,3,-5,-2
10875,Oi Buggers!,,aja2718,2.00,8,-1,7
10874,Outside The Box,,axorion,3.00,2,0,2
10873,Cross's Information (Version 3),,drmazhar,3.25,4,0,4
10872,Crosses,,drmazhar,2.40,3,0,3
10871,turn around,,gootipapa,2.13,4,0,4
10870,Smile,,FESP2018,2.00,1,-2,-1
10869,Stop Counting,,aja2718,2.13,7,-1,6
10868,P&tail,,engr100project,1.42,6,-3,3
10867,Broken square,,scorpio,3.67,9,0,9
10866,Selection ,,KMFS100,1.31,7,-5,2
10865,Green Hat,,UICejj,1.75,4,-2,2
10864,CS 111,,dogWithnoLegs,1.31,24,-5,19
10863,Snake Loop,,KSJBJKNN,1.90,6,-1,5
10862,Volcanic Disaster,,project,2.70,4,-2,2
10861,Walking in the forest,,aja2718,1.54,7,-3,4
10860,Leftover Spaghetti ,,aja2718,2.22,4,-1,3
10859,Diagonal,,csproject20,1.21,21,-7,14
10858,A,,csproject20,1.14,70,-17,53
10857,Linked list 6,,drmazhar,3.00,3,0,3
10856,4 times -1 then +1 to the end,,drmazhar,3.33,2,0,2
10855,Football,,axorion,3.00,4,0,4
10854,Iteration - cs111,,robozzle01,1.83,7,-1,6
10853,Cross's Information (Version 2),,drmazhar,3.00,1,0,1
10852,Diagon Alley 2,,axorion,3.00,0,0,0
10851,Wacky Christmas Tree,,fesp2018,2.75,2,0,2
10850,Selection,,j3s1,1.28,11,-5,6
10849,Changing Colors,,KSJBJKNN,2.00,5,-1,4
10848,Diagon Alley,,axorion,3.00,2,0,2
10847,Easy Spiral,,aja2718,1.90,6,-1,5
10846,Odd Edges,,aja2718,3.00,1,-1,0
10845,Selection,,FESP2018,2.00,6,-1,5
10844,easy part2,,Jumao,1.55,9,-1,8
10843,Randomized Reds,,aja2718,2.22,6,-1,5
10842,Cross's Information,,drmazhar,3.00,2,0,2
10841,Green addition,,scorpio,3.25,1,0,1
10840,Turn on not blue II,,drmazhar,2.55,11,0,11
10839,@ symbol,,admwuic,1.20,17,-9,8
10838,Iteration Focus,,j3s1,1.75,6,-3,3
10837,Function call puzzle,,UICejj,1.42,5,-5,0
10836,Function Call - cs111,,robozzle01,1.45,4,-6,-2
10835,Turn on not blue,,engr100project,1.22,17,-6,11
10834,bounce off red!,,engr100project,2.13,4,-1,3
10833,Instructions on Red,,UicEJJ,2.00,6,-1,5
10832,A maze full of stars,,j3s1,1.25,72,-13,59
10831,bv2,,engr100project,1.18,33,-10,23
10830,Function Calls,,j3s1,1.19,38,-12,26
10829,"Left-loop Green, Right-loop Red",,KSJBJKNN,2.13,5,0,5
10828,Memory,,fesp2018,2.11,6,-1,5
10827,Twice Minus Two,,axorion,3.40,4,0,4
10826,+/- 1,,drmazhar,2.40,3,0,3
10825,Starry,,imjha,1.58,8,-2,6
10824,Double Iteration in Red. ,,FESP2018,2.00,4,-2,2
10823,Discarding Deuces,,axorion,3.40,4,0,4
10822,function_call,,KMFS100,1.36,9,-2,7
10821,Small copy,,drmazhar,2.60,2,0,2
10820,Snowflake,,project,1.55,7,-2,5
10819,To The Bill ,,project,1.30,16,-6,10
10818,75% (Version 3),,drmazhar,2.71,5,0,5
10817,Iteration,,KMFS100,1.22,65,-14,51
10816,Drunken stack 3,,scorpio,4.00,1,0,1
10815,chewata,,KMFS100,1.35,19,-10,9
10814,Drunken stack 2,,scorpio,4.00,1,0,1
10813,The Code,,aja2718,2.29,4,-1,3
10812,Random Roads,,drmazhar,2.67,2,0,2
10811,Destroy Infinity,,project,1.33,13,-3,10
10810,Hidden Solution,,aja2718,1.38,9,-2,7
10809,Is there an easy way?,,neenthewiser,1.75,9,-2,7
10808,Rectangle,,drmazhar,2.40,3,0,3
10807,Space Mission,,project,1.25,9,-7,2
10806,Reparing roads,,drmazhar,2.80,3,0,3
10805,Vortical Horizons,,axorion,3.00,0,0,0
10804,The Not Spiral,,aja2718,1.83,5,-3,2
10803,"Red Block, Green Block",,aja2718,2.33,4,-1,3
10802,Symmetry :) 9 fixed version II,,drmazhar,2.40,2,0,2
10801,The Last Stand,,axorion,3.50,2,0,2
10800,Pop only greens,,drmazhar,2.80,4,0,4
10799,Shadow Puppets,,axorion,2.60,5,0,5
10798,EASSSSYYYYYYY! (2),,imjha,1.27,11,-2,9
10797,Strange stack,,scorpio,3.36,16,0,16
10796,Easy,,Jumao,1.50,8,-2,6
10795,Fractal IV,,scorpio,3.00,1,0,1
10794,Fractal III,,scorpio,3.00,1,0,1
10793,From spiral to pyramid II,,scorpio,3.75,5,0,5
10792,Pyramid (Version 2),,drmazhar,3.00,2,0,2
10791,From systemitic spiral to sold Pyramid,,drmazhar,3.00,3,0,3
10790,Push only Green,,drmazhar,2.50,3,0,3
10789,Square with the hole II,,scorpio,3.00,2,0,2
10788,Squares in Squares,,jnpollack,3.75,1,0,1
10787,Tit for Tat,,axorion,4.00,2,0,2
10786,Bleachers,,axorion,3.00,2,0,2
10785,Decreasing Rectangles,,drmazhar,3.00,2,0,2
10784,Streams with +,,drmazhar,2.50,5,0,5
10783,Greed and Charity,,axorion,4.00,1,0,1
10782,Another Row Would Be Nice,,jnpollack,4.00,0,0,0
10781,Solid Cross Cracker,,jnpollack,4.00,1,0,1
10780,Cross Cracker,,jnpollack,4.00,1,0,1
10779,Treasure Hunters III,,drmazhar,2.60,2,0,2
10778,Right or Left,,drmazhar,2.20,7,0,7
10777,Square with the hole,,scorpio,4.00,1,0,1
10776,Green Switch - a beginner puzzle,,jnpollack,2.00,3,0,3
10775,The ‚ÄúS‚Äù W,,jnpollack,3.00,4,0,4
10774,Put Signs For Your Ways (Version 15),,drmazhar,3.00,2,0,2
10773,Simplicity - Squares and Brackets,,jnpollack,4.00,1,0,1
10772,Simplicity - Braided Arrow,,jnpollack,2.00,7,-1,6
10771,Drunken stack,,scorpio,3.33,4,0,4
10770,Left or Right with Double,,drmazhar,2.80,4,0,4
10769,Spaced Out,,axorion,3.00,2,0,2
10768,pretty trash ,,ssluggard,1.35,12,-3,9
10767,Designing a puzzle,,silver,1.57,6,-5,1
10766,More than the number of the beast,,scorpio,4.50,1,0,1
10765,Innies & Outies,,axorion,3.00,4,0,4
10764,Linked Squares (Version 16),,drmazhar,2.00,2,0,2
10763,Shrek's ears,,aja2718,2.20,3,-1,2
10762,From systemitic spiral to sold triangle ,,drmazhar,3.00,3,0,3
10761,Dispersion (Version 6),,drmazhar,2.67,1,0,1
10760,> 6000,,jnpollack,4.00,0,0,0
10759,Necklace,,silver,1.21,14,-1,13
10758,Take and Give,,drmazhar,4.00,1,0,1
10757,Drunken Wiggling,,jnpollack,3.33,3,0,3
10756,easy turn and go,,sungyeonpark,1.43,8,-3,5
10755,lbq,,jnpollack,3.75,2,0,2
10754,Learning from Failure,,jnpollack,4.00,0,0,0
10753,Push Pop Flip Flop,,axorion,3.00,4,0,4
10752,High Chairs,,axorion,3.00,2,0,2
10751,Increasing Squares II,,drmazhar,3.00,4,0,4
10750,76 Trombones,,axorion,4.00,1,0,1
10749,A trip to the top (Part 6),,drmazhar,2.13,4,0,4
10748,4 Forwards and 5 Lefts,,jnpollack,4.00,1,0,1
10747,Only Right,,drmazhar,2.25,4,0,4
10746,Sawtooth Boomerang (Hard),,jnpollack,4.00,1,0,1
10745,Sawtooth Boomerang (Lite),,jnpollack,2.20,2,0,2
10744,Sawtooth Blade,,jnpollack,1.88,3,-1,2
10743,Spiral construction,,scorpio,3.00,3,0,3
10742,What am I doing?,,21s5023,1.43,4,-4,0
10741,Star Chasing,,jnpollack,2.33,3,0,3
10740,Math is EZ,,silver,2.30,7,-1,6
10739,Noob,,silver,1.80,6,-1,5
10738,Imprisoned [Caged II],,jnpollack,4.50,1,0,1
10737,Prolongation of the stack IV (Spiral edition),,scorpio,4.00,1,0,1
10736,I like Spiral,,drmazhar,3.00,2,0,2
10735,Nothing Tricky,,jnpollack,2.00,5,-1,4
10734,I Heart Spirals,,jnpollack,3.75,1,0,1
10733,Interstices,,axorion,5.00,1,0,1
10732,I Hate Spirals,,jnpollack,3.33,0,0,0
10731,I Really Don‚Äôt Like Spira,,jnpollack,3.50,1,0,1
10730,I Don‚Äôt Like Spira,,jnpollack,1.82,7,-1,6
10729,36 Chambers of Shaolin,,jnpollack,4.50,1,0,1
10728,Divisible by X,,drmazhar,3.00,2,0,2
10727,Shift One,,drmazhar,3.75,3,0,3
10726,The Guide (Version 4),,drmazhar,3.50,3,0,3
10725,Heuristic Search,,drmazhar,4.00,2,0,2
10724,Award Ceremony,,jnpollack,3.00,1,0,1
10723,Spiral with holes.,,drmazhar,3.00,3,0,3
10722,Switch at Green,,drmazhar,3.00,4,0,4
10721,Miyagi Need Puzzle Painted,,jnpollack,2.67,4,0,4
10720,ANNA AND ELLIE REAL PUZZLE,,elliotttitus,1.75,3,-4,-1
10719,Brandon's Creation,,tkiesel,1.60,5,-3,2
10718,Okayyyy,,Not_A_RoBot,2.00,2,-1,1
10717,Right on red,,CjSparks,1.39,10,-2,8
10716,Wheel of 8s,,jnpollack,4.00,1,0,1
10715,Peaks and Valleys,,jnpollack,3.80,3,0,3
10714,ym1,,ym1029sun,1.30,23,-6,17
10713,Puzzle,,emmakp,1.89,5,-1,4
10712,Color Maze...yay,,s5246737,1.82,5,0,5
10711,Whirly Birdy ,,sparnell20,1.25,28,-8,20
10710,wormy worm,,walkergore,1.67,13,-3,10
10709,CS Principles Project,,KyleL12,2.43,4,-1,3
10708,Calling All BoZZleheads,,jnpollack,3.75,1,0,1
10707,dancing cactus,,haedan563,1.23,31,-6,25
10706,puzzle,,Yebincha,1.14,49,-5,44
10705,bbb,,etn107,1.21,43,-16,27
10704,Mr. Keisel takes dubs ,,s420100,1.76,7,-5,2
10703,Color Coding,,carterharris,1.67,4,-4,0
10702,Easy Peasy,,pga627,1.24,34,-6,28
10701,Smile!,,chlohewitt,2.14,2,-2,0
10700,The One Wheel Car,,setnado,3.60,2,-1,1
10699,Elliott's Puzzle,,elliotttitus,1.90,5,-1,4
10698,The birkic 1.0,,chrisgonz,1.58,5,-3,2
10697,d,,KatD1212,1.23,24,-2,22
10696,Spin,,s420185,1.32,34,-5,29
10695,simple,,libbyhyry,1.45,4,-2,2
10694,Just Enough Fuel,,jnpollack,3.80,2,0,2
10693,Green Herring,,21s5039,1.50,6,-2,4
10692,ABS,,drmazhar,3.50,1,0,1
10691,Monochromatic spring,,scorpio,?,0,0,0
10690,We Built This City,,jnpollack,4.00,3,0,3
10689,From Rights To Lefts,,christiansh,1.67,8,-1,7
10688,West Coast,,22s4579,1.67,3,-3,0
10687,Turn left on,,20s4182,2.43,5,-1,4
10686,Square vortex II,,scorpio,4.00,1,0,1
10685,Transformer,,drmazhar,2.80,3,0,3
10684,"Yep, kinda easy",,DanielLee,1.44,10,-2,8
10683,Little brother of 10019,,jnpollack,4.40,2,0,2
10682,Replication Engine 12,,drmazhar,2.80,4,0,4
10681,Mr. T,,21s5023,1.86,6,-1,5
10680,Optimal Proportions,,axorion,2.75,0,0,0
10679,Fin,,drmazhar,3.25,2,0,2
10678,A Square Deal IV - A Done Deal,,jnpollack,3.00,1,0,1
10677,Star Path,,Rondholz,1.59,11,-5,6
10676,Move It - Move It,,Rondholz,1.61,12,-6,6
10675,Functions Example,,Rondholz,1.15,34,-7,27
10674,Star-Crossed,,Firebird,1.82,5,0,5
10673,Treasure Hunters II,,drmazhar,2.50,5,0,5
10672,A Square Deal III,,jnpollack,4.00,1,0,1
10671,Noob Bait,,jnpollack,2.56,6,-1,5
10670,red elephant,,scorsese,2.33,1,0,1
10669,1,,scorsese,1.62,7,-3,4
10668,green-red,,tyu1,1.67,6,-3,3
10667,a bow ,,morganlewis,1.18,44,-6,38
10666,Easy - Peasy - Lemon - Breezy,,19s4105,2.00,7,-1,6
10665,My Cup Runneth Over,,jnpollack,2.88,5,0,5
10664,Line In The Sand,,axorion,2.57,5,0,5
10663,EASYYYYYYYY!!!!!!!!!!!,,imjha,1.27,42,-13,29
10662,Robozzle Basics: Exercise 3,,Rondholz,1.44,14,-6,8
10661,Robozzle Basics: Exercise 2 ,,Rondholz,1.27,53,-13,40
10660,Robozzle Basics: Exercise 1,,Rondholz,1.28,15,-3,12
10659,Robozzle Basics: Exercise 1,,Rondholz,1.35,22,-6,16
10658,Conditional Inspiration,,axorion,3.50,1,0,1
10657,Conditional distances,,drmazhar,2.25,4,0,4
10656,Butterfly (Paint your way II),,scorpio,3.00,1,0,1
10655,0,,s4233010,1.78,6,-2,4
10654,Liam Coffey,,KyleL12,2.33,6,-1,5
10653,avery,,liambenkel,1.78,8,-2,6
10652,L,,scoffey,1.60,5,-4,1
10651,Backup & Restore (Version 8) ,,drmazhar,3.00,4,0,4
10650,Remember in Green,,drmazhar,2.80,4,0,4
10649,"You're my boy, azure!",,jnpollack,4.00,3,-1,2
10648,Remember in Red,,drmazhar,3.00,3,0,3
10647,Triangle on Wheels,,setnado,3.00,1,-1,0
10646,Half Life,,drmazhar,3.00,4,0,4
10645,liam v2,,KyleL12,2.11,6,-1,5
10644,Special Case of Reflection. (Version 4),,drmazhar,3.20,3,0,3
10643,The Blue One,,19s4105,1.89,6,-2,4
10642,eGG,,19s4105,1.50,9,-1,8
10641,dewwed,,19s4105,1.67,5,-3,2
10640,Changing directions,,drmazhar,2.50,4,0,4
10639,Divisable By 3,,drmazhar,1.35,12,-2,10
10638,hey liam,,KyleL12,1.25,20,-7,13
10637,Dynamic Sub Memories,,drmazhar,2.75,2,0,2
10636,liam,,xxraddragonxx,2.33,4,-2,2
10635,Static Sub Memories,,drmazhar,3.00,2,0,2
10634,The Wheel ,,Aaron39,1.29,26,-5,21
10633,Information Gathering 5,,drmazhar,2.40,2,0,2
10632,Easy Does It,,axorion,3.50,5,0,5
10631,The Trouble With Zero: Chapter 2,,axorion,3.50,1,0,1
10630,The Trouble With Zero,,axorion,3.00,1,0,1
10629,Fin 2 (10113 refashioned),,jnpollack,?,0,0,0
10628,Upsizing Engine (Version 9),,drmazhar,3.00,2,0,2
10627,Miniaturization Engine (Version 8),,drmazhar,3.00,2,0,2
10626,Red Skull,,MAKER,1.70,5,-4,1
10625,Precursor,,jnpollack,3.40,3,0,3
10624,Pass,,maxlegrice,2.00,8,-2,6
10623,Turning Over a New Leaf,,jnpollack,3.00,1,0,1
10622,Sequential Terminators,,axorion,3.00,4,0,4
10621,Timothreus,,axorion,3.40,4,0,4
10620,Road Map,,drmazhar,3.00,1,0,1
10619,Tim's Puzzle #30,,TimThree,2.60,2,0,2
10618,Round and Round,,CjSparks,1.43,6,-1,5
10617,Common in quarters (Version 3),,drmazhar,2.33,4,-1,3
10616,Common in quarters (Version 2),,drmazhar,2.57,4,0,4
10615,Common in quarters,,drmazhar,2.80,4,0,4
10614,spiral,,bananaman15,1.39,14,-2,12
10613,Read & Adapt (Adapted Version),,drmazhar,3.00,1,0,1
10612,Read & Adapt,,drmazhar,1.80,7,-1,6
10611,Umbrella (with remix),,jnpollack,2.25,2,-1,1
10610,Safecracker,,axorion,2.20,3,-1,2
10609,Undislikeable,,axorion,3.50,1,0,1
10608,Locksmith,,axorion,3.50,2,0,2
10607,Color Blind,,axorion,3.50,1,0,1
10606,a,,drmazhar,1.14,54,-10,44
10605,Growing Up (Version 2),,drmazhar,2.75,1,0,1
10604,One Week Past Due,,axorion,3.50,0,0,0
10603,Growing Up,,drmazhar,2.00,5,0,5
10602,The Comman,,drmazhar,2.18,8,0,8
10601,Waltz,,Parad0x,2.75,2,0,2
10600,Hidden Half,,drmazhar,2.11,5,-1,4
10599,u,,drmazhar,2.60,3,0,3
10598,The story of Reds,,drmazhar,3.67,1,0,1
10597,Branching Spiral,,benjaminRR,3.00,2,0,2
10596,Half,,drmazhar,2.60,5,0,5
10595,Zigzag's Proporty,,drmazhar,2.50,3,0,3
10594,Umbilical Severance,,jnpollack,5.00,1,0,1
10593,Spirals unboxing,,scorpio,3.00,1,0,1
10592,Accursed Puzzle,,axorion,3.00,1,0,1
10591,Small Spiral II (Without Painting),,drmazhar,2.00,7,0,7
10590,From Spiral to Spiral,,axorion,3.40,5,0,5
10589,Duolithic,,jnpollack,?,0,0,0
10588,Epitome of Hypocrisy,,jnpollack,2.40,3,0,3
10587,From Spiral to stair.,,drmazhar,2.29,5,0,5
10586,From Stair to Spiral,,drmazhar,2.75,2,0,2
10585,Turn on green XIV,,axorion,3.33,2,0,2
10584,Turn on green II,,benjaminRR,3.40,4,0,4
10583,Turn on green,,benjaminRR,3.14,4,0,4
10582,Queus from Stacks,,drmazhar,3.20,3,0,3
10581,Pyramid,,drmazhar,2.63,15,0,15
10580,Labyrinth tracing 1.1,,scorpio,4.00,0,0,0
10579,Labyrinth tracing,,scorpio,4.50,1,0,1
10578,Caged,,jnpollack,3.00,1,0,1
10577,Hey Scorpio,,jnpollack,4.00,0,0,0
10576,Green signal ,,drmazhar,1.85,10,0,10
10575,Conditions,,drmazhar,3.00,3,0,3
10574,You Disliked Puzzle 10573?,,jnpollack,4.00,0,0,0
10573,Such a Cruel Game,,jnpollack,1.88,3,-4,-1
10572,Q from Stack,,drmazhar,2.75,3,0,3
10571,Redz,,fffrank,1.77,19,0,19
10570,Compact shockwave,,scorpio,3.00,3,0,3
10569,Growing wave,,scorpio,3.00,0,0,0
10568,"Grattis, Softa!",,jnpollack,3.67,1,-1,0
10567,Damping wave,,drmazhar,2.30,4,0,4
10566,Narrowing spiral,,scorpio,3.00,1,0,1
10565,Sarting from 1 to 15 & ending at 1 to 5,,drmazhar,3.00,3,0,3
10564,store moves !,,ussef_bhl,1.80,13,0,13
10563,Information Gathering 4,,drmazhar,3.00,3,0,3
10562,Unnecessary ,,drmazhar,2.33,3,0,3
10561,Push Blue and don't pop Blue.,,drmazhar,2.57,5,0,5
10560,2 or (3/2),,drmazhar,3.00,1,0,1
10559,a,,drmazhar,3.00,1,0,1
10558,Lifelines,,jnpollack,2.00,1,-1,0
10557,5058 scaled down & turned around,,jnpollack,2.60,1,0,1
10556,Get The address (Version 12),,drmazhar,3.00,2,0,2
10555,Line of symmetry (Version 2),,drmazhar,2.75,3,0,3
10554,Freedom without rights,,jnpollack,3.60,4,0,4
10553,90,,jnpollack,3.80,1,0,1
10552,Another Replication Engine (Version 3),,drmazhar,2.80,1,0,1
10551,Line of symmetry.,,drmazhar,3.00,10,0,10
10550,Colored radiator,,scorpio,2.67,1,0,1
10549,Radiator,,drmazhar,1.79,8,0,8
10548,Another Replication Engine (Version 2),,drmazhar,3.00,3,0,3
10547,Dispersion (Version 5),,drmazhar,2.50,2,0,2
10546,2 Cases,,drmazhar,3.00,2,0,2
10545,Binary (6 digits),,scorpio,4.00,0,0,0
10544,Push Here pop there,,drmazhar,2.80,1,0,1
10543,Color Matching,,drmazhar,2.11,6,-1,5
10542,Paint your way,,scorpio,3.00,0,0,0
10541,Get The address (Version 11),,drmazhar,3.00,0,0,0
10540,Area of figure,,scorpio,3.00,0,0,0
10539,Another Replication Engine,,drmazhar,2.80,3,0,3
10538,Difference of two squares II,,scorpio,4.00,0,0,0
10537,Difference of two squares,,scorpio,3.00,0,0,0
10536,Nine Lives,,axorion,2.75,2,0,2
10535,Dispersion (version 4),,drmazhar,2.40,3,0,3
10534,Dispersion (Version 3),,drmazhar,2.57,5,0,5
10533,Stars formation in a galaxy II,,scorpio,3.67,2,0,2
10532,W,,axorion,2.67,1,0,1
10531,Broken Auger,,axorion,3.50,3,0,3
10530,Sound graph,,ussef_bhl,2.00,6,0,6
10529,Linked Squares (Version 15),,drmazhar,3.40,3,0,3
10528,watch the green,,ussef_bhl,2.20,4,0,4
10527,42 puzzle,,ussef_bhl,1.62,6,-4,2
10526,Turn right onece,,ussef_bhl,2.16,13,0,13
10525,Hard heart,,ussef_bhl,1.89,5,0,5
10524,Stars formation in a galaxy,,scorpio,3.50,1,0,1
10523,Auger,,axorion,3.25,2,0,2
10522,trollollol,,Steven1209,?,0,0,0
10521,Right Angled & Equilateral Triangle,,drmazhar,2.08,10,0,10
10520,Odd or Even (Version 3),,drmazhar,2.17,1,0,1
10519,Odd or Even (Version 2),,drmazhar,2.00,4,0,4
10518,eazy,,Steven1209,2.05,14,-2,12
10517,... ho Whuitt,,Steven1209,1.90,3,0,3
10516,Bonne chance,,Steven1209,2.33,3,0,3
10515,Square vortex,,scorpio,3.00,3,0,3
10514,... I can't but I can ... WHAT ?!?,,Steven1209,1.75,4,-1,3
10513,puzzle facil,,Steven1209,1.26,22,-6,16
10512,Parallelogram.,,drmazhar,2.50,5,-1,4
10511,Factors of the Pyramid.,,drmazhar,3.00,4,0,4
10510,Locations,,drmazhar,3.00,4,0,4
10509,Lot of holes,,drmazhar,1.82,6,-1,5
10508,Another speed control 5,,drmazhar,2.14,5,0,5
10507,test commande,,Steven1209,1.24,11,-7,4
10506,Comperision,,drmazhar,3.00,2,0,2
10505,easy boucle,,Steven1209,1.65,17,-1,16
10504,to be honest this puzzle is clickbait,,19s4105,1.50,7,-1,6
10503,Programed Spiral.,,drmazhar,2.43,5,0,5
10502,Stages of Spiral Growth.,,drmazhar,3.00,4,0,4
10501,Confusion Road,,OchenLord,1.83,7,-1,6
10500,Conditional Counting.,,drmazhar,3.00,2,0,2
10499,red turn,,mrgoodway,1.57,9,-3,6
10498,Postponed Pop,,drmazhar,1.90,7,0,7
10497,Dual purpose,,drmazhar,2.31,14,0,14
10496,Self Guide Built in (Version 2),,drmazhar,3.33,4,0,4
10495,Replication Engine 11,,drmazhar,2.57,7,0,7
10494,Is it Random?,,drmazhar,3.33,1,0,1
10493,Morpheus Gives Neo a Bad Batch of Pills,,jnpollack,?,0,0,0
10492,Embeded Stacks,,drmazhar,2.50,4,0,4
10491,Don‚Äôt Solve This Puzz,,jnpollack,1.00,2,0,2
10490,Partial Relapse,,jojois74,2.67,3,0,3
10489,10 command,,andrej226,1.27,31,-13,18
10488,Invisble Signs,,drmazhar,2.80,3,0,3
10487,Visible Signs.,,drmazhar,2.75,3,0,3
10486,Whale,,Tangler,1.43,6,-7,-1
10485,Stack Delay Snake,,alion02,2.75,5,0,5
10484,Complex snake,,alion02,3.33,5,0,5
10483,Seth,,jnpollack,1.46,4,-4,0
10482,Captain Squares,,jnpollack,?,0,0,0
10481,No trivials with border patrol,,jnpollack,3.00,1,0,1
10480,No trivials allowed.,,jnpollack,1.75,2,-2,0
10479,Dispersion (Version 2),,drmazhar,1.57,9,0,9
10478,snake,,Tangler,1.58,9,-1,8
10477,zombie,,Tangler,1.83,4,-1,3
10476,Dispersion,,drmazhar,2.50,2,0,2
10475,The Guide (Version 3),,drmazhar,2.60,2,0,2
10474,Mind The Gap,,19s4105,1.89,6,-1,5
10473,1 Star,,19s4105,1.26,36,-7,29
10472,Red Line,,axorion,2.50,2,0,2
10471,Stairs painting,,scorpio,3.00,1,0,1
10470,The Lost reds (Version 2),,drmazhar,2.50,5,0,5
10469,The lost Reds,,drmazhar,2.50,5,0,5
10468,Conditional painting.,,drmazhar,2.75,2,0,2
10467,e,,ethio992,1.59,24,0,24
10466,Simple Spiral,,ethio992,1.90,26,-1,25
10465,duck,,Tangler,1.80,6,-1,5
10464,toilet,,Tangler,1.30,17,-3,14
10463,dragon,,Tangler,1.88,3,-5,-2
10462,Pop Directions,,drmazhar,3.33,1,0,1
10461,checkers-hourglass,,sueno1,2.14,7,-1,6
10460,Programmed Snake,,jojois74,2.56,18,0,18
10459,Ternary (4 digits),,scorpio,5.00,0,0,0
10458,Conditional Engine,,drmazhar,3.00,0,0,0
10457,Miniaturization Engine (Version 7),,drmazhar,2.50,4,0,4
10456,Upsizing Engine (Version 8),,drmazhar,2.33,4,0,4
10455,colours,,blackcat,1.60,7,-3,4
10454,red,,blackcat,1.60,6,-2,4
10453,minecraft,,blackcat,1.24,16,-9,7
10452,titan,,blackcat,1.27,19,-5,14
10451,destiny,,blackcat,1.53,6,-9,-3
10450,When do i jump? & How many jump?,,drmazhar,2.75,3,0,3
10449,When do i jump?,,drmazhar,3.00,3,0,3
10448,EDEN 90¬,,VAllenet,1.88,5,-1,4
10447,Layers of Squares ,,drmazhar,3.00,1,0,1
10446,loops,,19s4105,2.50,9,0,9
10445,a,,drmazhar,1.35,14,-7,7
10444,The Big Surprise,,19s4105,2.09,5,0,5
10443,I AM BACK BABY!!!,,19s4105,1.44,12,-6,6
10442,super easy,,big_river773,1.14,115,-21,94
10441,Implicitly Explicit,,axorion,3.20,3,0,3
10440,Differentiation,,drmazhar,2.57,3,-1,2
10439,Integeration,,drmazhar,2.50,9,0,9
10438,1367 Return,,axorion,3.00,1,0,1
10437,"checkers, but with a twist",,sueno1,1.56,20,-1,19
10436,checker block,,sueno1,1.67,4,-2,2
10435,Summation (Version 3),,drmazhar,3.40,3,0,3
10434,Systematic Spirals ,,drmazhar,2.38,3,0,3
10433,spyrale fantasy,,Lucas_Galand,1.69,6,-1,5
10432,"Push,Back,Pop,Repeat",,drmazhar,2.75,1,0,1
10431,"Back,Forward,Forward,Repeat",,drmazhar,3.00,3,0,3
10430,The Guide (Version 2),,drmazhar,2.80,3,0,3
10429,The brain,,SeaMoon69,2.00,4,-2,2
10428,The Guide,,drmazhar,2.00,5,0,5
10427,Line,,VAllenet,2.50,4,0,4
10426,Zig-Zag-2,,VAllenet,2.43,3,-1,2
10425,Simle !,,SeaMoon69,1.90,2,-5,-3
10424,Under The Sea,,drmazhar,3.00,3,0,3
10423,MOON,,VAllenet,2.38,4,-1,3
10422,Tipping Point,,kraker,2.57,4,0,4
10421,Snake,,VAllenet,2.00,5,-1,4
10420,Get the address (Version 10),,drmazhar,2.60,2,0,2
10419,Tricky Stars,,kraker,2.57,5,0,5
10418,A trip to the top (Part 5),,drmazhar,2.50,2,0,2
10417,Zig-Zag,,VAllenet,2.33,8,0,8
10416,Three Functions,,VAllenet,2.38,3,0,3
10415,Filter (Version 2),,drmazhar,3.33,3,0,3
10414,In[version 3],,MasterLuk,2.75,3,0,3
10413,In[version 2],,MasterLuk,3.00,0,0,0
10412,Negative Detector,,MasterLuk,3.00,2,0,2
10398,Filter,,drmazhar,2.88,13,0,13
10386,Obstacle Course,,axorion,3.67,2,-1,1
10385,One red two stars,,Myhlat,1.30,18,-4,14
10384,Light Square Logic,,MasterLuk,3.00,0,0,0
10383,Red Hooks,,axorion,3.67,1,0,1
10382,Right Over,,axorion,3.00,2,0,2
10381,Bottom Up,,drmazhar,3.60,3,0,3
10380,Memory for Directions,,drmazhar,3.20,3,0,3
10379,Jumpers,,kraker,2.88,16,0,16
10378,Linked Crosses,,drmazhar,3.40,3,0,3
10377,Triple Discrete Distances,,drmazhar,2.86,5,0,5
10376,Jeweled Heart,,MasterLuk,3.75,1,0,1
10375,Odd or Even,,drmazhar,2.80,3,0,3
10374,Why not,,19s10279,1.20,78,-20,58
10373,Conditional Reflection,,drmazhar,3.25,1,0,1
10372,Illuminati,,XxjupiterxX,2.22,4,0,4
10371,Slowing down,,kraker,4.00,2,0,2
10370,2 star,,20s4164,1.57,6,-2,4
10369,Curliy Whirliy II,,19s4105,2.11,4,0,4
10368,Kindle your heart 1.1,,scorpio,2.50,2,0,2
10367,Kindle your heart,,scorpio,3.50,5,0,5
10366,42#3,,kigiri,1.53,9,-2,7
10365,Momma don't know 'bout the bees in the ground,,19s4105,1.32,14,-1,13
10364,NANI !?!,,19s4105,1.75,6,-1,5
10363,++,,drmazhar,3.25,3,0,3
10362,XOR Logic Processor,,MasterLuk,3.29,4,0,4
10361,Special Spiral (Version 2),,drmazhar,2.33,8,0,8
10360,Replicate blue,,kraker,3.33,4,0,4
10359,Riddled Blueprint,,MasterLuk,3.00,1,0,1
10358,Replication I,,erikkonstas,3.57,5,0,5
10357,Special Spiral,,drmazhar,2.44,13,0,13
10356,Properties of Symmtery,,drmazhar,2.78,4,0,4
10355,Reloop,,ductr27,1.60,8,-1,7
10354,A Trip to the Top (Part 4),,drmazhar,3.00,3,0,3
10353,The Joker,,kraker,?,0,0,0
10352,Turn in half,,drmazhar,3.29,5,0,5
10351,Simple,,nolypoly,1.18,57,-22,35
10350,q q q,,scifista42,3.00,2,-1,1
10349,Mouse,,scifista42,4.00,0,0,0
10348,Master Path,,scifista42,2.67,2,0,2
10347,Wiggle Waggle,,19s4105,1.75,5,-1,4
10346,The Mistletoe,,19s4105,2.09,4,-1,3
10345,Cube see another cube,,MaxHeros05,1.21,20,-7,13
10344,Binary counting + 1,,scorpio,4.00,0,0,0
10343,The Roundabout II,,19s4105,2.13,14,0,14
10342,Suitcase,,kraker,2.75,1,0,1
10341,Put Signs For Your Ways (Version 14),,drmazhar,3.33,4,0,4
10340,aPut Signs For Your Ways (Version 13),,drmazhar,2.00,3,0,3
10339,Perfectly Off Center,,19s4105,1.77,4,-1,3
10338,Hellow,,avgj,1.60,7,-2,5
10337,Righ or left that is a question?,,drmazhar,1.85,6,-1,5
10336,Using Painting as memory,,drmazhar,3.00,0,0,0
10335,Iteration,,nolypoly,1.23,17,-10,7
10334,Test Part 1,,monkeyninja,2.50,3,0,3
10333,The Red Fence,,19s4105,1.26,16,-3,13
10332,Unvisable Cross,,drmazhar,2.38,5,0,5
10331,Red Hot Mess!,,19s4105,2.33,3,0,3
10330,"""@""",,19s4105,1.63,15,0,15
10329,The Blue Cake,,scifista42,3.50,0,0,0
10328,NeM,,19s4105,1.27,14,-4,10
10327,Robonado,,scifista42,3.00,1,0,1
10326,From Half to Double,,drmazhar,2.86,5,0,5
10325,Subtraction,,drmazhar,3.00,3,0,3
10324,Regular,,scifista42,?,0,0,0
10323,Discrete distances,,drmazhar,3.00,4,0,4
10322,Tree Traversal 2,,scifista42,3.25,3,0,3
10321,Tree Traversal,,scifista42,4.00,0,0,0
10320,Put Signs For Your Ways (Version 12),,drmazhar,2.25,3,0,3
10319,Calculate Modulo 4,,scifista42,5.00,1,0,1
10318,Calculate Modulo 3,,scifista42,5.00,1,0,1
10317,Another kind of memory.,,drmazhar,2.40,5,0,5
10316,Distance Is Key,,scifista42,3.60,3,0,3
10315,Region's Reflection,,drmazhar,2.40,3,0,3
10314,Data Mining (Version 5),,drmazhar,2.38,4,0,4
10313,Powers of 2 (Simple without painting),,drmazhar,3.33,0,0,0
10312,Powers of 2 (inclusive) Fixed,,axorion,4.00,1,0,1
10311,Powers of 2 (inclusive),,axorion,2.33,5,0,5
10310,Powers of 2 (improved),,scorpio,4.00,1,0,1
10309,Greater or Smaller or Equal,,drmazhar,3.00,2,0,2
10308,Powers of 2,,scorpio,4.00,1,0,1
10307,Add and Check for eqivalance.,,drmazhar,4.00,1,0,1
10306,Terrorist Buildings,,axorion,3.27,11,0,11
10305,Terraced Buildings,,axorion,3.00,14,0,14
10304,Layers of spiarls,,drmazhar,4.00,1,0,1
10303,The Maze of Justice,,19s4105,1.57,10,-3,7
10302,Exponential shape,,scorpio,4.00,1,0,1
10301,PAC-MAN,,axorion,3.50,4,0,4
10300,Hard Greens.,,drmazhar,2.75,1,0,1
10299,Random color change,,ikod,2.57,5,0,5
10298,Reverse on Double,,drmazhar,2.09,6,0,6
10297,Space Invader,,axorion,4.00,0,0,0
10296,Data Mining (Version 4),,drmazhar,3.25,2,0,2
10295,Tutorial. Functions 2,,ikod,?,0,0,0
10294,Exponential tree,,scorpio,4.00,1,0,1
10293,Road Map,,drmazhar,3.33,4,0,4
10292,eeeeeeeeeeeeeeeeeeee,,19s4105,1.67,5,-4,1
10291,Tutorial. Functions,,ikod,2.10,3,0,3
10290,Get me out of this cage,,kraker,3.00,0,0,0
10289,Temple ,,axorion,2.67,2,0,2
10288,Time to open your gifts!,,scorpio,3.75,3,0,3
10287,Tim's Puzzle #29,,timthree,3.00,0,0,0
10286,Light Spiral (Version 2),,drmazhar,2.80,3,0,3
10285,Light Spiral,,drmazhar,3.00,4,0,4
10284,Prolongation of the stack III,,scorpio,3.67,2,0,2
10283,So near and yet so far,,ikod,2.20,3,0,3
10282,Prolongation of the stains II,,edsaw,4.00,2,0,2
10281,Prolongation of the stack II,,scorpio,3.33,2,0,2
10280,Easy Nine ,,ikod,1.50,5,-1,4
10279,Prolongation of the stains,,edsaw,5.00,1,0,1
10278,Trickster (limited),,ikod,1.85,9,0,9
10277,Prolongation of the stack,,scorpio,3.33,2,0,2
10276,Mountains (limited) uneven number edition,,ikod,2.00,6,0,6
10275,Mountains (limited) even number edition,,ikod,1.89,5,0,5
10274,Hard Eight,,ikod,2.38,3,0,3
10273,Sum logic required (limited),,ikod,1.48,15,-1,14
10272,Linked Squares (Version 14),,drmazhar,3.50,4,0,4
10271,NASCAR 2,,axorion,3.00,0,0,0
10270,Kidbot 5 - Recognize this?,,flarghsnoofter,1.86,4,0,4
10269,Kidbot 3 - Giant steps,,flarghsnoofter,1.26,9,-2,7
10268,Kidbot 4 - Funny steps,,flarghsnoofter,1.22,30,-10,20
10267,"Kidbot 2 - Do ""F2"" at the end of F1.",,flarghsnoofter,1.25,12,-3,9
10266,Kidbot 1 - Tiny tree,,flarghsnoofter,1.17,35,-17,18
10265,Get the address (Version 9),,drmazhar,3.25,3,0,3
10264,Feeling a little cross II,,drmazhar,3.00,3,0,3
10263,Capitalist Swine,,matchucentric,1.35,10,-3,7
10262,NASCAR,,axorion,3.50,1,0,1
10261,How can you go back? (Vrsion 2),,drmazhar,2.43,10,0,10
10260,Jacquard,,axorion,?,0,0,0
10259,Colors separation,,scorpio,4.00,0,0,0
10258,Highlander,,axorion,3.43,4,0,4
10257,How can you go back?,,drmazhar,3.00,4,0,4
10256,Nebulous,,axorion,3.00,0,0,0
10255,Cheap Knockoff,,axorion,3.00,0,0,0
10254,Dead Reckoning II,,scorpio,3.00,0,0,0
10253,Nineteen,,axorion,3.00,0,0,0
10252,Dead Reckoning,,axorion,4.00,2,0,2
10251,Palace,,Emma13,1.53,11,-3,8
10250,Labirint,,Emma13,1.80,5,-2,3
10249,The Horizontal Plane,,19s4105,1.35,12,-3,9
10248,Upsizing Engine (Version 7),,drmazhar,2.83,5,0,5
10247,Miniaturization Engine (Version 6) ,,drmazhar,3.22,8,0,8
10246,The Corkscrew,,19s4105,1.70,5,-1,4
10245,Colors 2.0,,483119,2.15,15,-5,10
10244,Pinwheel,,axorion,3.00,3,0,3
10243,"73%, I guess III",,drmazhar,3.33,2,0,2
10242,"73%, I guess II ",,drmazhar,3.43,4,0,4
10241,Hector Can't beat,,421850,1.36,13,-8,5
10240,The Reef,,19s4105,1.27,17,-2,15
10239,One Step Forward Two Steps Back,,axorion,3.00,5,0,5
10238,"73%, I guess",,kraker,3.42,11,0,11
10237,Selection,,Uic_cs,1.20,44,-19,25
10236,The Spatula.,,19s4105,1.56,3,-1,2
10235,"Select,Copy,Paste,Repeat.",,drmazhar,2.75,8,0,8
10234,About 42%,,kraker,3.14,5,0,5
10233,75% (Version 2),,drmazhar,2.83,4,0,4
10232,Jump!,,kraker,3.00,0,0,0
10231,Get the address (Version 8),,drmazhar,3.20,4,0,4
10230,Function Calls,,csuic123,1.64,6,-2,4
10229,Iteration,,csuic123,1.22,119,-27,92
10228,Get the address (Version 7),,drmazhar,3.33,5,0,5
10227,Hard Road,,drmazhar,3.00,5,0,5
10226,Choose your path,,Dvalen2,1.89,16,0,16
10225,Color wheel selector,,engr100cs,1.19,33,-8,25
10224,Change painting,,engr100cs,1.56,8,-1,7
10223,Around we go,,engr100cs,1.17,89,-25,64
10222,Loop Around,,project2fann,1.91,6,-2,4
10221,Puzzle#5omg yasssss,,yashmansisid,1.42,5,-4,1
10220,Gobstopper,,ENGRGAHJ,2.00,4,-1,3
10219,Puzzle #4,,yashmansisid,1.22,32,-12,20
10218,One legged bean,,sags,1.89,3,-1,2
10217,Backwards L,,vsmh100,1.31,13,-3,10
10216,EXAMPLE,,sags,1.67,4,-2,2
10215,Follow the Path,,vsmh100,1.73,3,-4,-1
10214,Recursive Puzzle,,CsEngr,2.25,2,-3,-1
10213,Challenge puzzle,,cseng,2.33,2,0,2
10212,SelectionFESP21,,UIC21Duo,2.14,8,-1,7
10211,Bar graph,,engr100group,1.30,17,-3,14
10210,The Path,,uic21duo,1.86,3,-2,1
10209,IterationFESP21,,UIC21Duo,1.67,7,-2,5
10208,ChallengeFESP'21,,UIC21Duo,2.50,3,0,3
10207,The Wheel,,uic21duo,1.29,15,-3,12
10206,Letter P,,CsEngr,2.29,5,-1,4
10205,Around the block,,vsmh100,1.33,7,-1,6
10204,Climb n Slide the Pyramid,,engrsquad,1.80,5,0,5
10203,Broken Key,,engrsquad,1.70,5,0,5
10202,Don't Touch the Lava,,crackincoldone,1.47,12,-5,7
10201,Focus: Symmetry?,,edaEngi100,1.64,7,-1,6
10200,"Function calling, with a twist ;)",,engrsquad,1.28,11,-2,9
10198,mix,,crackincoldone,1.50,4,-4,0
10197,Selection,,engrsquad,1.50,7,-4,3
10196,Focus: Function Calls,,edaEngi100,2.00,5,-1,4
10195,Function Call,,Uic_cs,1.44,18,-10,8
10194,Iteration,,Uic_cs,1.17,55,-28,27
10193,Spiral,,engr100group,1.29,17,-11,6
10192,Overthinking,,jordanchen23,1.86,4,-3,1
10191,Reuse and recycle,,lazerSharks,1.78,3,-3,0
10190,Puzzle #5: Combination,,engr100group,1.86,4,-1,3
10189,Remember your steps,,lazerSharks,2.00,4,-2,2
10188,Simple Logic,,gokulraj,1.19,32,-9,23
10187,CounterClockwise,,lazerSharks,1.25,22,-7,15
10186,Crossed,,gokulraj,1.86,3,-2,1
10185,Iterate,,pbrbois,1.75,7,-2,5
10184,BackWard Stairs,,lazerSharks,1.58,9,-1,8
10183,iteration? ,,MDD100,1.26,18,-10,8
10182,Spiral Out,,tmyb,2.33,4,-2,2
10181,Tricky snake,,tmyb,1.86,2,-2,0
10180,function function and functions,,MDD100,1.21,31,-11,20
10179,easy recursive function call,,MDD100,1.17,46,-17,29
10178,function call,,MDD100,1.20,79,-24,55
10177,unintuitive robo puzzle,,lazerSharks,2.00,3,-1,2
10176,RecklessSnake,,tmyb,1.27,44,-12,32
10175,selection,,MDD100,1.75,5,-2,3
10174,uniqueTitle,,crackincoldone,1.29,35,-12,23
10173,abcdefghijklmnopqrstuvwxyz,,485536,1.86,11,-2,9
10172,Function #5,,capost4,2.38,3,-1,2
10171,"Selections,function calls, and iterations",,uicjim,1.88,2,-3,-1
10170,mirror F,,uicjim,1.27,16,-6,10
10169,star(fixed),,edaengi100,1.90,5,-1,4
10168,Star,,edaengi100,1.38,6,-1,5
10167,Snake,,uicjim,1.16,75,-19,56
10166,Puzzle 4,,uicjim,1.57,8,-1,7
10165,Puzzle #5,,Super32,1.50,7,-1,6
10164,Function Call,,teamfesp,1.57,4,-2,2
10163,Blue Box Step,,engr100group,2.13,2,-1,1
10162,Functions and Iterations,,Super32,2.13,1,-3,-2
10161,Iteration,,Super32,1.33,26,-7,19
10160,Selections Puzzle,,Super32,1.64,8,-1,7
10159,Functions Puzzle ,,Super32,1.89,3,-2,1
10158,Selection/Function Call,,teamfesp,1.21,14,-4,10
10157,Focus: Multiple,,edaEngi100,1.89,4,-1,3
10156,Puzzle #4: Combination,,engr100group,1.67,6,-3,3
10155,Focus: Iteration,,edaEngi100,1.23,40,-7,33
10154,ROSE,,proj2smehro4,1.88,5,0,5
10153,Iteration Puzzle,,zpatel24,1.27,21,-6,15
10152,Puzzle #5,,uicjim,1.24,23,-3,20
10151,Tree,,CS_squad,1.80,4,0,4
10150,Function Calls,,pbrbois,1.59,10,-2,8
10149,selection square,,cseng,2.43,3,-1,2
10148,test 2,,csengr,1.31,8,-7,1
10147,Test 1,,csengr,1.30,21,-19,2
10146,Puzzle #4,,capost4,2.11,4,-1,3
10145,Cupids Arrow,,proj2smehro4,1.27,15,-5,10
10144,function calls,,pbrbois,1.25,28,-9,19
10143,selection,,pbrbois,1.70,5,-1,4
10142,intricate,,CSSqwad,2.80,3,0,3
10141,Selection Puzzle,,zpatel24,1.21,14,-11,3
10140,Spinning Diagonally,,gokulraj,1.80,1,-1,0
10139,Puzzle #3,,capost4,1.80,7,-2,5
10138,Troy's Selection,,whoisjuan,1.50,8,-2,6
10137,Christmas,,gokulraj,1.78,4,-2,2
10136,Too lazy to think of a title,,Dvalen2,2.00,5,0,5
10135,Claustrophobia,,crackincoldone,1.67,6,-2,4
10134,Twick o Tweak,,vsmh100,1.83,6,0,6
10133,Loops,,dvalen2,1.47,5,-5,0
10132,Vin ,,vsmh100,2.11,3,0,3
10131,Function and Iteration,,Dvalen2,1.56,4,0,4
10130,Color Coaster,,capost4,1.87,7,-2,5
10129,Selection/Function Call,,capost4,1.23,16,-9,7
10128,Reach for the Stars,,gokulraj,1.31,15,-4,11
10127,Puzzle #5,,csproj2,1.80,4,-1,3
10126,Iteration #1,,capost4,1.19,25,-12,13
10125,Merry Christmas w/ a Little Blue - Function Calls,,EngrGAHJ,1.54,5,-1,4
10124,EZ iteration,,cseng,1.89,4,0,4
10123,Function Calls only new,,whoisjuan,1.50,8,-1,7
10121,Greenhouse,,kraker,2.25,5,0,5
10120,Why tho ,,cseng,2.40,3,0,3
10119,Selection Puzzle,,CsEngr,1.23,66,-10,56
10118,Stairs,,proj2smehro4,1.53,10,-2,8
10117,Blue moon,,zpatel24,1.26,11,-12,-1
10116,Function puzzle,,zpatel24,1.46,5,-2,3
10115,Pleb Style Puzzle,,CSRobozzle123,1.73,7,-1,6
10114,Red Fish,,CSRobozzle123,1.80,5,0,5
10113,Fin.,,MiniProj2,1.80,4,-1,3
10112,Jump,,EOBS,1.89,3,-2,1
10111,Puzzle#3 ,,yashmansisid,1.28,18,-2,16
10110,Its weird,,MiniProj2,2.29,2,-1,1
10109,Weird,,EOBS,1.86,4,-2,2
10108,Hola,,EOBS,1.67,3,-3,0
10107,8tupus,,EOBS,2.13,5,0,5
10106,Random,,EOBS,1.80,2,-1,1
10105,Neck turner,,MiniProj2,2.29,4,0,4
10104,I Got My Sights on Computer Science!,,CHOlyzNAVramM2,1.50,7,-2,5
10103,a small twist,,MiniProj2,1.56,5,-1,4
10102,Turn Left,,mlgroblox,1.22,33,-6,27
10101,Ping it back,,MiniProj2,2.13,4,0,4
10100,Computer Science Junction-Funktion!,,CHOlyzNAVramM2,1.89,4,-2,2
10099,The Squared Cycle,,Dvalen2,1.35,12,-3,9
10098,Computer-Science Iteration Obliteration!,,CHOlyzNAVramM2,1.25,33,-13,20
10097,Iteration,,teamfesp,1.21,25,-5,20
10096,Computer Science Natural Selection ENG 100,,chonavramlyzen,1.34,21,-6,15
10095,Computer Science! Natural Selection,,chonavramlyzen,1.28,7,-7,0
10094,Stars and Spade,,Eng100Puzz,1.33,12,-2,10
10093,Selection,,teamfesp,1.19,40,-13,27
10092,Computer Science Natural Selection!!,,chonavramlyzen,1.22,43,-15,28
10088,Iteration/Selection,,teamfesp,1.25,40,-9,31
10087,Computer Science Whirly!,,chonavramlyzen,2.40,2,-1,1
10084,Maze,,engrjal,1.80,8,0,8
10078,Selection Puzzle ,,engrGAHJ,1.64,5,-1,4
10077,Spiral,,engrjal,1.22,53,-11,42
10076,Star,,engrjal,1.28,19,-2,17
10075,Odyssey,,tmyb,2.00,4,0,4
10074,Stairs,,engrjal,1.67,1,-3,-2
10073,Deep Sea Submarine,,abk123,1.67,4,-1,3
10072,Target,,engrjal,2.00,2,-1,1
10071,Function Calls for the Win,,CSRobozzle123,1.50,4,-1,3
10070,Snake,,csproj2,2.50,2,-1,1
10069,Snake,,csproj2,2.40,1,0,1
10068,S-type,,tmyb,1.45,5,-1,4
10067,Iteration for the Win,,CSRobozzle123,1.38,3,-4,-1
10066,Selection for the Win,,CSRobozzle123,1.46,5,-2,3
10065,STAR,,csproj2,1.56,10,0,10
10064,Functionality,,fantastic,2.14,3,-2,1
10063,Selection,,CSSqwad,1.33,23,-9,14
10062,Puzzle #4 Patience,,fantastic ,1.64,6,-1,5
10061,Puzzle #2,,csproj2,2.11,5,0,5
10060,Function Calls (Puzzle#3),,project2fann,2.00,6,-1,5
10059,Oops Forgot Something,,engr100proj,1.28,12,-2,10
10058,$,,CS_squad,1.18,37,-12,25
10057,Mixed Puzzle,,fantastic,1.22,92,-11,81
10056,8,,ENGRGAHJ,2.11,5,0,5
10055,Puzzle #1,,csproj2,1.43,6,-1,5
10054,Function,,CSSqwad,2.00,4,0,4
10053,Function-Iteration ,,CSSqwad,2.29,3,0,3
10052,iteration?,,crackincoldone,1.91,6,-1,5
10051,Two Squares,,engr100proj,1.50,7,-1,6
10050,Slant 2,,axorion,1.86,4,0,4
10049,Slant,,axorion,2.11,6,0,6
10048,Four Square,,ashbgp,1.15,77,-17,60
10047,Reverse Spiral,,Eng100Puzz,1.47,12,-1,11
10046,blarg,,mlgroblox,2.00,6,-1,5
10045,Selection,,mlgroblox,1.90,4,-1,3
10044,trojan,,yashmansisid,1.35,12,-1,11
10043,Figure 8,,Eng100Puzz,1.21,89,-14,75
10042,Function with Iteration,,mlgroblox,1.64,6,-1,5
10041,75%,,drmazhar,2.11,9,0,9
10040,"Said, then done",,Eng100Puzz,1.71,6,-1,5
10039,Choose Your Path,,Eng100Puzz,1.27,17,-4,13
10038,Down then up (Version 3),,drmazhar,3.00,4,0,4
10037,Broda,,yashmansisid,1.38,5,-2,3
10036,4 direction,,abk123,1.50,3,-5,-2
10035,Iteration,,abk123,1.33,18,-1,17
10034,Loopy Loop ,,abk123,1.44,13,-1,12
10033,Iteration #2,,proj2smehro4,1.19,19,-8,11
10032,Iteration #1,,proj2smehro4,1.64,7,-1,6
10031,Selection,,abk123,1.28,17,-2,15
10030,Red And Green,,jenny01,1.17,48,-12,36
10029,Ladder,,ENG330,1.56,9,-2,7
10028,Selection Puzzle ,,fantastic,1.20,47,-10,37
10027,Repetation,,fantastic,1.22,39,-13,26
10026,Sports car,,kingfisher3999,1.46,7,-5,2
10025,Jumpy,,project2fann,1.42,6,-2,4
10024,Functions ~ functions,,jenny01,1.60,10,-1,9
10023,Puzzle #2,,CSENGR100,1.35,10,-3,7
10022,Function calls,,project2fann,1.45,5,-1,4
10021,Cup of Koffee,,jenny01,1.75,3,-2,1
10020,Puzzle #3 (Function Calls),,CSENGR100,1.50,5,-4,1
10019,Challenge #2,,csengr100,1.89,7,-1,6
10018,up the stairs and around,,jenny01,1.83,6,-2,4
10017,Glasses,,EdgyBanana,1.50,9,-4,5
10016,Puzzle #1 (Selection),,csengr100,1.64,5,-3,2
10015,Challenge #1,,csengr100,1.54,6,-3,3
10014,Anchor,,project2fann,1.67,8,-2,6
10013,around and stairs,,jenny01,2.00,4,-1,3
10012,Spiral from Modern towers,,drmazhar,2.80,4,0,4
10011,Again and Again,,ENGRGAHJ,2.22,2,-2,0
10010,Modern Towers,,drmazhar,2.50,7,0,7
10009,Right on ? ,,edgybanana,1.80,4,0,4
10008,A Risible Riddle,,teamnaha,1.83,3,-1,2
10007,Jigars puzzle,,kingfisher3999,1.25,13,-5,8
10006,#5,,ferric2,1.50,7,-1,6
10005,#4,,ferric2,1.50,7,-2,5
10004,#3,,ferric2,1.29,10,-3,7
10003,#2,,ferric2,1.44,10,-3,7
10002,#1,,ferric2,1.55,5,-1,4
10001,That's It?,,teamnaha,2.60,0,-2,-2
10000,Half Information (Version 5),,drmazhar,2.33,6,-2,4
9999,Half Information (Version 4),,drmazhar,2.60,5,0,5
9998,A New Flag,,engr100proj,2.00,2,-1,1
9997,Magic Band II,,kraker,4.00,1,0,1
9996,Overwrite Blue,,slayer,3.40,2,-1,1
9995,Sarcophagus,,axorion,3.00,4,0,4
9994,Magic Band,,kraker,3.00,1,0,1
9993,Scaning the Pyramid,,drmazhar,2.43,6,0,6
9992,L is for Loop,,CS_Squad,2.67,3,0,3
9991,Google it,,teamnaha,2.11,3,-1,2
9990,A Flipping Ordinary Flop,,axorion,2.50,0,0,0
9989,Box box,,kingfisher3999,1.18,30,-13,17
9988,Troy's Function Calls ,,whoisjuan,1.80,5,-1,4
9987,Pan,,kingfisher3999,3.00,4,-1,3
9986,Troy's Selection,,whoisjuan,2.00,5,-1,4
9985,Crossed,,ENG330,1.19,19,-4,15
9984,Conjunction Finction,,ENG330,1.35,11,-5,6
9983,Minecraft Axe,,engr100proj,1.18,28,-15,13
9982,Smile,,engr100proj,1.80,3,0,3
9981,Traz Challenging 2,,trazengr100,2.00,4,0,4
9980,There and Back,,ENG330,1.17,37,-20,17
9979,Traz Functions,,trazengr100,1.24,21,-7,14
9978,Star Selection,,ENG330,1.25,14,-5,9
9977,Traz Challenging 1,,trazengr100,2.00,3,-1,2
9976,Traz Iteration,,trazengr100,1.21,21,-10,11
9975,Traz Selection,,trazengr100,1.67,6,-2,4
9973,Checkers ,,jordanchen23,1.70,4,-2,2
9972,flyby,,jordanchen23,1.67,4,-2,2
9971,Sea of Red Stars,,jordanchen23,1.75,2,-1,1
9970,The Mouth of a Monster,,19s4105,1.89,4,-1,3
9969,Alternating Alternator,,19s4105,1.83,7,-1,6
9968,Magic Stairs,,kraker,3.25,2,0,2
9967,The Magic Square,,drmazhar,3.00,5,0,5
9966,Stairs,,team7,2.75,4,0,4
9965,Ups and Downs,,edgybanana,1.67,9,0,9
9964,Puzzle #2,,EdgyBanana,2.13,5,0,5
9963,I Wonder...?,,team7,2.13,5,-1,4
9962,Spiral Diral,,EdgyBanana,1.54,6,-2,4
9961,Function,,team7,1.46,4,-5,-1
9960,Functions!,,team7,1.67,5,-4,1
9959,"Half,Double,Double",,drmazhar,3.14,3,0,3
9958,Fizzle,,FriendlyClam,1.64,9,-1,8
9957,Too Much or Too Less?,,CS_Squad,2.33,0,0,0
9956,MUST use ALL slots,,team7,1.70,5,-1,4
9955,Notches Pickaxe,,ashinboi,1.80,4,0,4
9954,Long Way Around,,team7,1.70,3,-1,2
9953,"Decisions, Decisions",,Eng100Puzz,1.47,12,-1,11
9952,From me - To you.,,slayer,2.33,0,0,0
9951,Puzzle XI,,slayer,3.00,0,0,0
9950,This is a test,,akomons0,1.30,28,-15,13
9949,Mix 1,,team7,1.20,20,-8,12
9948,Selection?,,team7,1.19,64,-28,36
9947,Surrogate,,axorion,3.50,1,0,1
9946,Idiosyncratic,,teamnaha,1.69,8,-1,7
9945,Smile!,,teamnaha,1.30,10,-5,5
9944,The strange,,kingfisher3999,1.87,10,0,10
9943,hihihihihihihihi,,485536,1.54,11,-2,9
9942,Super Serious,,19s4105,1.73,7,-1,6
9941,When a bald man washes their face...,,19s4105,1.50,6,-1,5
9940,Wheel of Fortune,,kraker,3.00,0,0,0
9939,sorta hard,,vonzalen,1.75,6,-1,5
9938,On stage,,vonzalen,2.50,1,0,1
9937,Maze,,pbrbois,2.75,3,0,3
9936,Combination #2,,pvemu4,1.75,3,-1,2
9935,Combination #1,,pvemu4,1.86,3,-2,1
9934,Negatives 2,,axorion,3.67,2,0,2
9933,Down then Up (version 2),,drmazhar,3.50,0,0,0
9932,Up Then Down (Version 2),,drmazhar,3.50,1,0,1
9931,The Diamond,,19s4105,1.60,4,-1,3
9930,G-G-graphics,,sem8,1.32,12,-2,10
9929,Red Light Green Light,,project2fann,1.29,11,-4,7
9928,Recycle,,cseng,1.88,4,-1,3
9927,Loop de Froop,,19s4105,1.73,6,-1,5
9926,The Pole,,19s4105,1.50,5,-1,4
9925,Negatives,,kraker,3.00,3,0,3
9924,forked,,mlgroblox,1.75,5,-1,4
9923,Pattern,,engr100cs,1.28,12,-8,4
9922,Puzzle Numero Uno,,teamnaha,1.20,62,-20,42
9921,Recurse,,engr100cs,1.58,7,-2,5
9920,Crane Game!,,19s4105,1.80,3,-3,0
9919,Off-Center II,,19s4105,1.75,5,-3,2
9918,Up Then Down,,drmazhar,2.60,2,0,2
9917,The H,,CS_squad,2.00,6,-1,5
9916,Down then Up,,drmazhar,2.17,5,0,5
9915,good luck :P,,othersans,1.56,12,-1,11
9914,Sum of Greens 2,,axorion,3.00,3,0,3
9913,O Christmas Tree,,calliet,1.69,7,-1,6
9912,2 in a row,,niksan,1.88,6,0,6
9911,Sum of Greens.,,drmazhar,2.60,3,0,3
9910,Switches,,drmazhar,2.83,4,0,4
9909,4 is frog,,niksan,1.60,5,-1,4
9908,Pattern is important,,niksan,2.75,1,-1,0
9907,ProMan,,niksan,1.35,22,0,22
9906,_|,,niksan,1.35,13,-3,10
9905,D√©j√† ,,axorion,3.67,1,0,1
9904,1 Star 1 Dream,,CSSqwad,1.24,44,-11,33
9903,Off - Center,,19s4105,1.80,6,-2,4
9902,How would you hide a giraffe from the government?,,19s4105,1.67,6,-2,4
9898,Pyramid,,CSSqwad,1.33,17,-1,16
9897,PuzzleUno,,GingerSnap,1.59,10,-1,9
9896,JDUBHVDHJVFT,,485536,1.38,9,-4,5
9895,ur bad iIi: tHe THiRd Onne,,19s4105,1.75,5,-1,4
9894,ur bad ii: tHe awakeninG,,19s4105,1.30,14,-12,2
9893,Rich Stack II,,kraker,3.00,0,0,0
9892,Fractional Graduations ,,axorion,3.00,1,0,1
9891,corners,,vumaiya0,1.44,7,-4,3
9890,Turn left or skip the hole,,drmazhar,3.14,5,0,5
9889,selection,,pvemu4,1.26,22,-4,18
9888,function calls,,pvemu4,1.18,43,-13,30
9887,Iterations Puzzle,,pvemu4,1.58,5,-1,4
9886,No More Than Eight,,axorion,2.57,4,0,4
9885,Snake,,pbrbois,2.09,5,-1,4
9884,Less than or Equal,,drmazhar,2.00,5,0,5
9883,Rich Stack,,kraker,3.33,1,0,1
9882,IRN,,19s4105,1.91,7,-3,4
9881,"Red=half,Green=Double",,drmazhar,3.25,4,0,4
9880,Half Counting,,drmazhar,1.83,9,-1,8
9879,Double counting,,drmazhar,1.88,20,0,20
9878,ur bad,,19s4105,1.47,6,-2,4
9877,After Party,,kraker,1.89,6,0,6
9876,Kaboom!,,19s4105,1.82,6,-2,4
9875,bro,,485536,1.25,58,-13,45
9874,Egg Puzzle,,485536,1.71,9,0,9
9873,blueberries and apples,,485536,1.69,8,0,8
9872,Apple tree,,akabab,1.75,12,0,12
9871,Chinese Flag,,akabab,1.62,9,0,9
9870,Slither,,19s4105,1.50,4,-2,2
9869,Self guide built in,,drmazhar,1.53,11,-4,7
9868,Mirror with trigger,,scorpio,2.33,2,0,2
9867,The Blue Mirror,,drmazhar,2.33,4,0,4
9866,Carriage Return Line Feed,,kraker,3.00,0,0,0
9865,Green pulses ==> Square waves,,drmazhar,3.00,0,0,0
9864,f1again,,9651410232,1.58,6,-1,5
9863,Pong,,axorion,3.50,3,0,3
9862,swirls,,boby,1.57,8,0,8
9861,Perfect Hoops,,19s4105,1.90,5,0,5
9860,4-Oct,,485536,1.50,8,-1,7
9859,ABC 123,,485536,1.58,6,0,6
9858,The Curly Whirrly,,19s4105,1.90,5,-1,4
9857,H√,,avgj,1.91,5,-2,3
9856,The Dipstick,,19s4105,1.55,5,-2,3
9855,The Roundabout,,19s4105,1.60,6,-1,5
9854,Mickey Mouse,,avgj,1.83,6,-2,4
9853,e,,avgj,1.20,33,-8,25
9852,froney,,avgj,1.28,18,-8,10
9851,spiral web,,avgj,1.60,15,-1,14
9850,Magic C,,Bristoche,1.83,8,-1,7
9849,Stomach Cleaning,,drmazhar,3.00,3,0,3
9848,Mystery Ride,,avgj,3.00,2,-1,1
9847,smile,,avgj,1.32,9,-5,4
9846,magic B,,Bristoche,1.87,16,0,16
9845,Submit!,,avgj,1.47,9,-4,5
9844,non simmetry cross,,avgj,1.33,9,-4,5
9843,non symmetry cross,,avgj,1.27,11,-7,4
9842,snake,,avgj,1.46,8,-4,4
9841,Wow,,avgj,1.25,17,-12,5
9840,Stab In The Dark,,axorion,4.00,0,0,0
9839,The lion,,boby,1.50,7,0,7
9837,Green vines,,boby,2.00,2,0,2
9836,Squares.,,drmazhar,2.22,7,0,7
9835,LOOP,,boby,2.06,11,0,11
9834,CHECKERS,,boby,1.88,3,-1,2
9833,HUH?,,boby,1.53,13,0,13
9832,Ghost Rider,,kraker,2.50,4,0,4
9831,Right on double red,,Mattis,1.71,7,-2,5
9830,Postions of Green,,drmazhar,3.40,4,0,4
9829,"You say ""stop""",,kraker,2.25,5,0,5
9828,Confused,,drmazhar,2.25,4,0,4
9827,Half Full,,axorion,3.00,2,0,2
9826,Exit (Version2),,drmazhar,2.11,3,-4,-1
9825,Exit,,drmazhar,2.67,2,0,2
9824,Easter egg,,axorion,2.71,3,0,3
9823,Armour ,,avyay,1.23,21,-7,14
9822,Alternate Interior Angles ,,axorion,3.00,3,0,3
9821,push-me-pull-you light,,scorpio,3.00,0,0,0
9820,Upsizing Engine ( Version 6 ),,drmazhar,2.83,3,0,3
9819,Miniaturization Engine (Version 5) ,,drmazhar,3.20,2,0,2
9818,Projections,,drmazhar,2.33,2,0,2
9817,Help!!!!!!!!!!!!!!,,Mattis,1.73,10,-2,8
9816,Sequantial Sprials.,,drmazhar,3.00,0,0,0
9815,Fibonacci Spiral,,scorpio,3.00,0,0,0
9814,Detour Signage,,BobbyTables,2.44,5,0,5
9813,Langton's Ant,,BobbyTables,2.67,3,0,3
9812,For the belaboring of mr. Kraker,,axorion,3.00,3,0,3
9811,For the betterment of mr. Kraker ,,edsaw,2.40,4,0,4
9810,For the benefit of mr. Kite,,kraker,2.25,3,0,3
9809,For the benefit of mr. Kite,,kraker,2.33,2,0,2
9808,Colorful line,,21s5039,1.92,10,0,10
9807,Come in,,belenus,1.50,7,-1,6
9806,Miniaturization Engine (Version 4) ,,drmazhar,3.00,3,0,3
9805,Upsizing Engine ( Version 5 ),,drmazhar,3.14,7,0,7
9804,short maze,,tkiesel,1.69,4,-3,1
9803,Reflection of the difference,,drmazhar,3.75,4,0,4
9802,squiggly ,,madtho,2.11,4,-1,3
9801,First Puzzle,,harrisonpels,1.57,16,-1,15
9800,Core,,axorion,3.33,2,0,2
9799,Imma G,,agkieselcs,1.32,10,-4,6
9798,Diamond Facets,,axorion,2.70,5,0,5
9797,Back and Forth,,imgeniusgamer,1.80,5,-2,3
9796,trail,,5246697,1.30,19,-2,17
9795,jhyt,,5246697,1.59,13,-2,11
9794,very easy,,rusbel123,1.20,53,-10,43
9793,USA USA USA,,alexxavio,1.39,8,-7,1
9792,T-time,,jcast26,1.56,6,-2,4
9791,criss cross,,swagowag,1.80,5,-1,4
9790,Swirly Dirly,,TateRiehm,1.26,20,-9,11
9789,1 star,,hammy,1.33,25,-7,18
9788,Linked Rectangles,,drmazhar,2.45,9,0,9
9787,V.M.,,VictorM,1.26,31,-10,21
9786,Green Tree,,landrimassey15,1.82,6,0,6
9785,Coles Puzzle,,ColePeck,1.58,6,-1,5
9784,wack,,edgarenriquez,1.35,22,-9,13
9783,ez puzzle,,hannahsimon7,1.26,15,-15,0
9782,Colors,,483119,2.40,7,-1,6
9781,Turn it Around ,,hannahruthart,1.31,16,-6,10
9780,Ziggy,,paigehalbert,1.67,8,-1,7
9779,LIT,,Hismael_V123,1.26,19,-6,13
9778,overly_complicated,,juangomez440,1.26,27,-7,20
9777,Circulation,,znunn345,1.48,20,-2,18
9776,Life is good,,puttheed,1.33,18,-3,15
9775,Back then Repeat pt2,,ktchristian,1.55,5,-1,4
9774,3 stars,,abby3122,1.47,10,-2,8
9773,B-BALL,,Hinkle11,1.60,4,-3,1
9772,forewards?,,jjwgall,1.50,9,-2,7
9771,Left and Right,,abbysaker,1.92,7,-2,5
9770,Turn on Red,,Tyu1,1.89,5,-2,3
9769,Brandons puzzle ,,brandon2001h,1.80,5,-5,0
9768,Brandons puzzle ,,brandon2001h,1.60,5,-4,1
9767,noob lvl puzle,,FSGXGCOW,1.78,5,-2,3
9766,tates puzzle,,haroldchris,1.19,29,-9,20
9765,Conditional Loopdr,,drmazhar,3.29,4,0,4
9764,Fine Tune,,axorion,3.25,9,0,9
9763,Open Bob,,WilliamW,2.00,4,-3,1
9762,the HighWay,,483119,1.86,5,-1,4
9761,y y y,,485536,1.67,8,-3,5
9760,Choose your turn,,scorpio,2.91,9,0,9
9759,I'm fixing a hole,,kraker,3.00,2,0,2
9758,Diagon Alley,,axorion,3.00,1,0,1
9757,Copy the Paste (Version 2),,drmazhar,2.38,3,0,3
9756,Copy then Paste.,,drmazhar,1.89,3,0,3
9755,GOD ROBOZZLERS ONLY ( NOOBS KEEP OUT!!!!!!),,WilliamW,1.45,9,-9,0
9754,Area of Square II,,scorpio,4.00,1,0,1
9753,Swirly,,savannahmckean,1.30,12,-8,4
9752,Stacks of identical files.,,drmazhar,2.40,2,0,2
9751,Why Would You Do That?,,23s4610,1.58,16,-3,13
9750,Beez?!?,,YungSandwich,1.78,2,-2,0
9744,Computer Science!!!!!,,yashdalal,1.69,26,-1,25
9743,Correct Coordinates,,axorion,3.00,2,0,2
9742,Right Location (Version 20,,drmazhar,3.00,3,0,3
9741,Right Location,,drmazhar,2.71,5,0,5
9740,p fun design,,alishajones3,1.78,5,-1,4
9739,Wiggly worm,,npbd,2.11,4,-3,1
9738,Helter Skelter II,,drmazhar,2.29,1,-2,-1
9737,Robozzzzle,,s4236710,1.26,16,-9,7
9736,Matryoshka 2 II,,drmazhar,2.43,4,-1,3
9735,Found my way downstairs,,kraker,3.00,2,0,2
9734,Helter Skelter,,kraker,2.33,1,0,1
9733,Matryoshka 2,,axorion,3.00,4,0,4
9732,Matryoshka,,axorion,3.33,8,0,8
9731,Nested Memories,,drmazhar,3.33,4,0,4
9730,boord,,s306765,1.83,7,-3,4
9729,Most Symmetry,,edsaw,4.00,1,0,1
9728,The Target (Version 2),,drmazhar,1.82,6,-1,5
9727,The Target,,drmazhar,1.67,5,-3,2
9726,Boxing Ring,,axorion,3.00,0,0,0
9725,More Symmetry,,axorion,3.00,2,0,2
9724,Mere Symmetry,,axorion,2.57,3,0,3
9723,Roller Coaster II,,drmazhar,3.00,0,0,0
9722,Roller Coaster,,18111398,2.67,3,0,3
9721,puzzle 1,,walt_gober,1.44,9,-1,8
9720,color cunundrum,,haedan563,1.44,9,-4,5
9719,Up A Notch,,axorion,3.50,5,0,5
9718,reginald,,s5131398,1.58,9,-1,8
9717,Third Attempt,,isaacmaya,1.47,9,-1,8
9716,Jaws by NoHaC,,NoHaCs,1.50,5,-4,1
9715,"Oh no, this is the road to hell",,scorpio,3.00,0,0,0
9714,Ear Tag,,axorion,3.40,4,0,4
9713,Enjoy Egyption's Pyramids (version:2),,drmazhar,2.11,5,0,5
9712,Pure Symmteric (Version 3),,drmazhar,2.44,7,0,7
9711,Pure Symmteric (Version 2),,drmazhar,3.20,3,0,3
9710,Special Agent A,,arielseaulater,1.29,12,-6,6
9709,Ob-la-di Ob-la-da,,kraker,3.00,2,0,2
9708,I Dare You to Step Across This Line!,,leokaiser,2.50,3,0,3
9707,lol,,s311908,2.08,4,-6,-2
9706,FUNNNNNNN,,arielseaulater,1.71,6,-7,-1
9705,Pure Symmteric,,drmazhar,2.38,6,-1,5
9704,The Fire,,NoHaCs,1.75,3,-2,1
9703,kaylea's puzzle,,kayleahudson,1.86,10,-1,9
9702,Simpler than it seems,,valkyrie12310,1.79,5,-6,-1
9701,‹,,spacejam,1.47,11,-2,9
9700,Pepe,,Zac99,1.33,5,-5,0
9699,Backup & Restore 0.1,,scorpio,3.00,1,0,1
9698,Backup & Restore (Version 7),,drmazhar,3.00,3,-1,2
9697,Backup & Restore (Version 6),,drmazhar,2.50,4,0,4
9696,Blue Bridges,,drmazhar,2.17,4,-1,3
9695,Checkers Mainaaaaaaaaaaaa,,ubuntu,1.33,13,-11,2
9694,Follow the signs,,goetz,2.50,4,0,4
9693,Greetings,,jcamerynn,1.67,3,-1,2
9692,The long and winding road,,kraker,3.33,1,0,1
9691,Switch-Hitter,,wesaddington,1.73,7,-4,3
9689,the button,,cara1,1.55,4,-4,0
9688,Parity Strip,,goetz,3.00,1,0,1
9687,Stair steper,,Cara1,1.26,22,-9,13
9686,its your loss,,fgtomlin,1.33,21,-7,14
9685,ABCDEFG,,lienhan677,1.57,10,-3,7
9684,First puzzle,,arnoulm,1.82,7,-2,5
9683,Get back jojo,,kraker,3.67,2,0,2
9682,something,,Reaper715,1.69,6,-8,-2
9681,A square,,s3034835,1.45,14,-3,11
9680,Ladder,,Shaines,1.50,12,-1,11
9679,puzzle 1,,zachshort,1.60,9,-1,8
9678,the flex'n blue man,,bananaman15,1.33,11,-3,8
9677,I,,ismaelsalinas,1.60,8,-4,4
9676,Red Light,,dh915,1.64,10,0,10
9675,Lama Lama,,TripleScreens,1.50,5,-7,-2
9674,What Monster is this?,,TripleScreens,1.58,6,-1,5
9673,Swirl,,TripleScreens,1.35,24,-7,17
9672,Judd,,juddjjenkins,1.73,10,0,10
9671,Spooderman,,Maker,1.43,5,-7,-2
9670,Symmetry,,TripleScreens,1.38,20,-5,15
9669,this one is ez,,Nargoth7155,1.32,12,-5,7
9668,Just a simple thing,,Nargoth7155,1.33,6,-7,-1
9665,Get the address (Version 6),,drmazhar,2.86,4,0,4
9664,Get the address (Version 5),,drmazhar,3.00,3,0,3
9663,Get the address (Version 4),,drmazhar,2.86,4,0,4
9662,Version 1.0.1 [Final],,slayer,3.25,0,0,0
9661,Poker card,,PeleZheng,1.75,6,-3,3
9660,Downstairs with color,,swagbone,1.29,8,-11,-3
9659,Downstairs with color,,swagbone,1.30,11,-10,1
9658,Version 1.0,,slayer,3.33,0,0,0
9657,Dan's Puzzle,,dh915,1.83,7,-5,2
9656,Skyscrapers,,markthebrit,2.29,15,0,15
9655,Sean meek,,seanmeek2,1.30,19,-10,9
9654,life is full of twists and turns,,CarterG,1.58,5,-2,3
9653,Outstanding stars,,drmazhar,2.20,3,0,3
9652,Data Mining (Version 3),,drmazhar,3.00,1,0,1
9651,Some Cumbersome Cucumbers,,axorion,3.50,1,0,1
9650,Reds,,drmazhar,2.40,2,0,2
9649,Embrasures ,,axorion,3.00,3,0,3
9648,The Puzzle,,greendayrocks4,1.28,22,-10,12
9647,Memory Mangement,,drmazhar,2.33,4,0,4
9646,Donut,,almagonzalez,2.33,0,-1,-1
9645,The Beast,,haroldchris,1.50,5,-5,0
9644,Snakey,,TripleScreens,1.60,10,-2,8
9643,Stipulations,,R3K3R_J1M,2.20,1,0,1
9642,Puzzle,,ryan060203,1.64,3,-6,-3
9641,At least i tried,,daniel_313588,1.42,9,-13,-4
9640,Cross Stitch,,leokaiser,2.09,4,0,4
9639,Jesus Saved My Life!!,,therealcoffey,1.32,8,-3,5
9638,Saved,,durkinblock,?,0,0,0
9637,What do I do now?,,Manock,2.50,1,-1,0
9636,4 black squares,,brandonb,1.59,6,-5,1
9635,box,,dhayes3,1.50,4,-4,0
9634,Not what meets the eye,,Iruz,1.67,4,-3,1
9633,multi-tool,,spacejam,1.63,9,-2,7
9632,computerscienceprinciplespuzzle,,bennettlasater,1.82,4,-2,2
9631,zig zag,,connor_culp89,1.59,17,-1,16
9630,titler,,s4233010,1.77,7,-3,4
9629,grid,,Sparnell20,1.64,4,-2,2
9628,easy,,connorhayes,1.54,3,-4,-1
9627,skip,,s4233010,1.69,10,-1,9
9626,Notre Dame,,Equinoxed8192,2.25,4,-1,3
9625,Spiraling,,Equinoxed8192,1.50,8,-2,6
9624,Magnum,,axorion,2.33,4,0,4
9623,Colour changer,,Rosie2711,1.53,9,-2,7
9622,pool,,connorhayes,1.33,10,-8,2
9621,Aidans Puzzle,,aidanchrist,1.57,9,-2,7
9620,Gridlock,,TheAldrenStaff,2.17,10,0,10
9619,reds,,devnenon,1.75,8,-1,7
9618,Get The address (Version 3),,drmazhar,3.00,2,0,2
9617,Do it.,,AnnoyingEngine,1.32,13,-4,9
9614,Hard? I think?,,David_Reeder,2.08,6,-2,4
9613,Criss Cross,,NInjawolf772,2.00,5,0,5
9612,The Spiral,,NInjawolf772,1.20,13,-9,4
9611,Rad puzzle,,greendayrocks4,1.53,7,-4,3
9610,sideways boot,,s4233010,1.79,6,-3,3
9609,Get The address (Version 2),,drmazhar,3.14,4,0,4
9608,Back then Repeat,,aubreymorrisiv,1.71,8,-1,7
9607,boring and easy,,Jlopez13,1.47,8,-4,4
9606,Re-Weave,,leokaiser,2.10,6,-1,5
9605,Loopy 01,,tkiesel,2.25,13,-1,12
9601,Goad,,axorion,4.00,0,0,0
9600,Loop D Loop,,LanceP123,1.38,24,-3,21
9591,Aftershock,,axorion,3.75,2,0,2
9590,Measuring Problem II,,axorion,3.00,3,0,3
9589,Get The adress.,,drmazhar,2.17,8,0,8
9588,SmileItsFun,,seyje,1.80,5,-2,3
9587,-T,,kolyamba,2.19,11,0,11
9586,200,,kolyamba,1.68,12,-1,11
9585,Spiral Blob,,durkinblock,1.38,8,-1,7
9584,Measureing Problem.,,drmazhar,2.50,2,-1,1
9583,Actually Helpful Functions,,axorion,2.00,5,-1,4
9582,Tutorial 6: Helper Functions,,Rondholz,1.33,12,-4,8
9581,Scan from memory.,,drmazhar,2.50,4,0,4
9580,Diminished Copies II,,drmazhar,3.00,3,0,3
9579,Shockwave II,,drmazhar,2.83,3,0,3
9578,Shockwave,,axorion,3.43,5,0,5
9577,Tutorial 5: Recursion,,Rondholz,1.47,8,-5,3
9576,Tutorial 4: Recursion,,Rondholz,1.36,15,-3,12
9575,Tutorial 3 : Recursion ,,Rondholz,1.57,13,-6,7
9574,Turn memory 2,,beseech,3.00,2,0,2
9573,Wide angles,,scorpio,2.94,14,0,14
9572,Double growth,,scorpio,4.00,2,0,2
9571,Upsizing Engine version(4),,drmazhar,3.00,4,0,4
9570,Miniaturization engine (Version 3),,drmazhar,3.00,4,0,4
9569,"Blue Left, Red Right",,davidmisteryo,1.92,8,0,8
9568,Bagel,,beseech,2.38,4,0,4
9567,Turn memory,,beseech,2.80,3,0,3
9566,The Right red.,,drmazhar,2.00,2,-1,1
9565,Signs & Sub Signs,,drmazhar,3.40,3,0,3
9564,Construction with low resources,,scorpio,4.00,1,0,1
9563,Copy-Paste,,scorpio,3.00,1,0,1
9562,The opposite,,drmazhar,2.83,5,0,5
9561,Tutorial 2 - Movement Commands,,Rondholz,1.67,15,-5,10
9560,Tutorial 1 - Movement Commands,,Rondholz,1.33,18,-4,14
9559,Area of Square,,scorpio,3.00,3,0,3
9558,Move Forward,,Rondholz,1.24,21,-11,10
9557,Proportions,,scorpio,4.00,0,0,0
9556,Eleven Fifteenths,,axorion,2.50,1,0,1
9555,Synchronization,,drmazhar,3.00,0,-1,-1
9554,Internal Reflection with paint,,scorpio,4.00,1,0,1
9553,Diminished Copies,,axorion,3.67,4,0,4
9552,Internal Reflection,,drmazhar,3.00,0,0,0
9551,A special corner.,,drmazhar,2.75,7,0,7
9550,Complete enough,,scorpio,3.00,4,0,4
9549,Incomplete (Version 4),,drmazhar,2.44,5,0,5
9548,Decoration (Easy Version),,drmazhar,1.75,8,-2,6
9547,Decoration,,drmazhar,1.91,6,0,6
9546,First In Last Out Violator,,axorion,3.50,5,0,5
9545,heil 2,,jlediraipas,2.83,4,0,4
9544,heil,,jlediraipas,1.89,3,-2,1
9543,My first,,Isoka,1.64,7,0,7
9542,Miniaturization engine (Version 2),,drmazhar,3.14,5,0,5
9541,Upsizing Engine (Version 3),,drmazhar,3.00,2,0,2
9540,Bar,,kraker,3.17,3,0,3
9539,Drawing the short straw II,,drmazhar,2.50,2,0,2
9538,Stack Tutorial,,strikefinger,1.56,11,-2,9
9537,Cain,,kraker,2.86,3,0,3
9536,Interruptions,,kraker,3.00,5,0,5
9535,Boulders,,kraker,3.00,0,0,0
9534,Spiral,,remi200,1.86,6,-1,5
9533,Reflection Inside Spiral.,,drmazhar,2.75,3,0,3
9532,Linked Squares (Version 13),,drmazhar,2.71,3,0,3
9531,Circular ZigzZag.,,drmazhar,2.25,3,0,3
9530,Esoteric Redundancy,,axorion,3.75,3,0,3
9529,Upsizing engine (Version 2),,drmazhar,2.38,4,0,4
9528,A trip to the Middle,,drmazhar,2.57,4,0,4
9527,The bridge,,drmazhar,2.75,0,-1,-1
9526,Bill Engvall 1.1,,axorion,3.00,1,0,1
9525,The Refernce ,,drmazhar,2.83,2,-1,1
9524,Bill Engvall,,axorion,2.00,0,0,0
9523,Put Signs For Your Ways (Version 11),,drmazhar,2.38,5,0,5
9522,Mathematic function (version 2),,drmazhar,2.63,5,0,5
9521,Mathematic Function,,drmazhar,2.67,4,0,4
9520,Direct Sorting,,drmazhar,2.67,1,0,1
9519,Indirect Sorting,,drmazhar,3.33,0,0,0
9518,Another speed Control V,,drmazhar,2.67,1,0,1
9517,Mega Wiggle,,axorion,2.25,2,0,2
9516,Put Signs For Your Ways (Version 10),,drmazhar,2.83,4,0,4
9515,For all the pain,,mike239x,2.08,4,-1,3
9514,Right / Left,,AdrienRolly,1.53,9,-3,6
9513,Linked Spirals,,drmazhar,2.67,4,0,4
9512,Missleading Colors.,,drmazhar,1.86,4,0,4
9511,Jump mode,,kraker,2.50,5,0,5
9510,Skip mode,,kraker,2.22,2,-2,0
9509,Metro.,,drmazhar,2.63,4,-1,3
9508,Security Check,,kraker,2.50,4,-1,3
9507,Thickening,,kraker,2.67,4,0,4
9506,Pit stop,,mike239x,2.44,5,-1,4
9505,The Car's Engine.,,drmazhar,2.88,9,0,9
9504,Magic A,,Bristoche,2.00,3,-2,1
9503,Tims Puzzle 3 II,,drmazhar,1.80,6,-1,5
9502,Middle of the Stair.,,drmazhar,2.13,3,0,3
9501,Magic H,,Bristoche,1.88,2,-2,0
9500,3,,ticnit,1.53,11,-5,6
9499,Incomplete (Version 3),,drmazhar,2.50,2,-1,1
9498,kuter,,Bristoche,1.58,6,-1,5
9497,Pretzel Logic,,axorion,2.92,7,-1,6
9496,Signature II,,kraker,2.75,5,0,5
9495,Eneekass,,drmazhar,3.20,2,0,2
9494,wiggle,,Zhangtianshu,1.43,9,-1,8
9493,None,,Zhangtianshu,1.48,16,-12,4
9492,tight rope,,ticnit,1.47,16,-2,14
9491,Hackathon,,kraker,3.67,1,0,1
9490,Outer ring ,,kraker,4.00,2,0,2
9489,Red arrow,,sem8,1.84,23,-2,21
9488,Eeeaaasssyyy,,sem8,1.46,29,-8,21
9487,StEp,,sem8,2.05,20,-3,17
9486,Quest,,sem8,1.52,25,-1,24
9485,Door,,Zhangtianshu,1.76,19,-2,17
9484,Flashing squares,,scorpio,3.40,5,0,5
9483,Square shadow,,kraker,3.00,2,0,2
9482,The big L,,Zhangtianshu,1.24,34,-4,30
9481,Count to Change (Version 2),,drmazhar,2.25,6,0,6
9480,Count to Change.,,drmazhar,2.25,4,0,4
9479,Stringer ,,axorion,2.57,4,0,4
9478,Introstack,,kraker,2.60,5,0,5
9477,634 - That's my number,,kraker,2.83,4,0,4
9476,Half Half Half,,drmazhar,2.33,4,0,4
9475,Closing-in-jumping-out tutorial,,kraker,3.00,1,0,1
9474,Queue from Stack.,,drmazhar,3.33,1,0,1
9473,kitice :-),,maruska,1.54,8,-1,7
9472,Heavy Industry,,kraker,3.40,4,0,4
9471,Destack 4,,arkangelsk1,2.10,3,0,3
9470,Destack 3,,arkangelsk1,2.10,4,0,4
9469,Destack 2,,arkangelsk1,2.22,3,0,3
9468,Spiral-square,,kraker,4.00,2,0,2
9467,Colourful,,slayer,4.00,1,-1,0
9466,Expand & Contract,,kraker,4.00,1,0,1
9465,Half-time value,,kraker,3.50,2,0,2
9464,Half-time value,,kraker,4.00,1,0,1
9463,Simple equation.,,drmazhar,2.80,4,0,4
9462,gm009 II,,drmazhar,1.83,8,0,8
9461,Stealth bomber,,kraker,3.00,2,0,2
9460,Headlines revisited,,kraker,3.00,0,0,0
9459,incomplete (version 2),,drmazhar,3.60,3,0,3
9458,Reciprocal anger (mimetic desire),,kraker,3.00,0,0,0
9457,Incomplete.,,drmazhar,3.75,1,0,1
9456,3331,,kolyamba,1.70,2,-2,0
9455,Smiling chimp,,kraker,2.33,2,0,2
9454,45,,kolyamba,2.00,2,0,2
9453,MAHINA,,kolyamba,2.30,3,-2,1
9452,Suspension Bridge,,axorion,3.00,0,0,0
9451,Reflection Control.,,drmazhar,3.00,1,0,1
9450,Closing in and jumping out,,kraker,4.00,1,0,1
9449,Broadband,,kraker,3.67,0,0,0
9448,Linked Squares (Version 12),,drmazhar,3.00,1,0,1
9447,Pockets 2,,scifista42,2.80,2,-1,1
9446,Butterfly,,scifista42,1.82,8,-1,7
9445,Bleeding Cell,,scifista42,4.00,0,0,0
9444,Lake Cruiser,,scifista42,3.60,2,0,2
9443,Capacitor,,kraker,3.00,1,0,1
9442,Turning Formula,,scifista42,?,0,0,0
9441,Fourcast,,axorion,2.41,19,-1,18
9440,Memory Guide,,drmazhar,2.60,1,0,1
9439,Linked Squares (Version 11),,drmazhar,2.63,3,0,3
9438,Basic equipment ,,kraker,2.30,6,0,6
9437,Iphantse yangumthi!!!,,slayer,3.33,3,0,3
9436,Beat Five,,kraker,2.50,1,0,1
9435,Popping,,kraker ,3.00,1,0,1
9434,"Shooting star, or cross maybe ?",,LightDiscord,1.75,6,-2,4
9433,Guardrails 2,,scifista42,?,0,0,0
9432,Maze of R√©mi200 V,,remi200,1.86,3,-1,2
9431,Guardrails Training,,scifista42,2.11,5,0,5
9423,Signs,,drmazhar,2.67,5,-1,4
9422,Signature,,kraker,2.10,5,0,5
9421,Dissident,,drmazhar,2.50,2,0,2
9420,Guardrails,,scifista42,4.00,0,0,0
9419,Thorny Tendril,,scifista42,2.00,10,0,10
9418,Paint your puzzle IV,,kraker,3.00,1,0,1
9417,Pretzel,,scifista42,2.67,3,-1,2
9416,Bouncing,,kraker,3.20,3,0,3
9415,Put Signs For Your Ways (Version 9),,drmazhar,4.00,0,0,0
9414,T-moving Ant,,eyTns,?,0,0,0
9413,Pockets,,scifista42,2.67,2,-1,1
9412,key,,kolyamba,1.73,5,-2,3
9411,Rattlesnake,,scifista42,2.38,5,0,5
9410,Senior Mansions,,kraker,3.00,2,0,2
9409,Fire,,scifista42,3.20,2,0,2
9408,Count the reds,,scifista42,3.00,3,0,3
9407,Hourglass,,scifista42,3.00,0,-1,-1
9406,Big staircase,,scifista42,3.00,4,0,4
9405,Ammo Box,,scifista42,2.44,5,0,5
9404,Icecream,,scifista42,2.67,2,0,2
9403,Hash Art,,scifista42,2.56,5,0,5
9402,Spin 2 Win,,scifista42,1.90,3,-2,1
9401,Analog static,,scifista42,1.83,0,-3,-3
9400,Red tiles = Information,,drmazhar,2.38,9,0,9
9396,Knitting Infinity,,slayer,3.00,1,-1,0
9395,Linked Squares (Version 10),,drmazhar,3.00,3,0,3
9394,Basic obstacle,,scifista42,1.62,7,-2,5
9393,Broken Grate,,scifista42,2.75,1,0,1
9392,Green plus,,drmazhar,2.67,5,0,5
9391,Assymetrical Snail,,scifista42,2.13,5,0,5
9390,Destack,,arkangelsk1,2.00,5,-1,4
9389,eggy poo,,baldrick,1.50,8,-4,4
9388,Trigger,,drmazhar,3.25,2,0,2
9387,Proud business building,,kraker,3.50,0,0,0
9386,Industrial landscape,,kraker,3.50,2,0,2
9385,Cottages,,kraker,3.33,1,0,1
9384,Replication Engine VIII,,drmazhar,2.57,5,-1,4
9383,E.T. Phone Home,,kraker,3.00,3,0,3
9382,Green landmarks II,,kraker,3.00,0,0,0
9381,Reflection only with Green.,,drmazhar,3.25,2,0,2
9380,Greens,,drmazhar,2.40,4,0,4
9379,ThreeColor,,www2000,1.79,4,-3,1
9378,Backup & Restore (Version 5),,drmazhar,3.25,2,0,2
9377,Paint your puzzle III,,kraker,2.25,1,0,1
9376,Miniaturization engine.,,drmazhar,2.80,5,0,5
9375,Another speed control III,,drmazhar,2.50,1,0,1
9374,Modular multiplicative inverse,,scorpio,4.00,0,0,0
9373,Upsizing engine,,drmazhar,2.50,5,0,5
9372,Cleanup,,meculus,1.73,8,-1,7
9371,Counting Red tiles.,,drmazhar,2.80,3,-1,2
9370,Flower stack,,beseech,2.75,2,0,2
9369,The second stack.,,beseech,2.13,5,0,5
9368,First stack,,beseech,1.36,18,-8,10
9367,Column Chart (Version 5),,drmazhar,3.25,2,0,2
9366,Reflection Engineering (Version 2),,drmazhar,3.25,3,0,3
9365,Flower of the RoboZZle.,,drmazhar,1.80,6,-2,4
9364,Degeneration,,kraker,3.00,0,0,0
9363,Put Signs for your ways (Version 8),,drmazhar,2.67,2,0,2
9361,-44,,drmazhar,2.38,2,-1,1
9360,Mutation (new species) II,,kraker,4.00,1,-1,0
9359,Linked squares (Version 9),,drmazhar,2.33,6,-1,5
9358,Linked squares (Version 8),,drmazhar,2.33,3,0,3
9357,Replication hog,,kraker,3.25,3,0,3
9356,Square links 2,,axorion,2.67,1,0,1
9355,Linked squares (Vesion 7),,drmazhar,1.82,4,-2,2
9354,Green landmarks,,kraker,3.00,1,0,1
9353,Circular ...... (Version 2),,drmazhar,2.43,5,0,5
9352,Mutation (cancer),,kraker,?,0,0,0
9351,Mutation (new species),,kraker,?,0,0,0
9350,Laa (Version 2),,drmazhar,2.71,2,0,2
9349,Mutation attempt,,kraker,4.00,2,0,2
9348,Squares,,kraker,3.75,3,0,3
9347,Backup & Restore (Version 5),,drmazhar,2.50,3,-1,2
9346,Exponential,,kraker,3.33,2,-1,1
9345,stack,,limjunghyun,1.57,8,-1,7
9344,Replication Engine VII,,drmazhar,2.86,4,0,4
9343,hang man,,jlediraipas,?,0,0,0
9342,hang man,,jlediraipas,?,0,0,0
9341,Focal Point,,axorion,3.20,2,0,2
9340,Backup & Restore (Version 4),,drmazhar,3.00,3,0,3
9339,Replication Engine VI,,drmazhar,3.14,5,0,5
9338,read discreption,,lordsheep,1.92,15,-3,12
9334,Quarter information,,drmazhar,2.25,4,-1,3
9333,Half Information (Version 3),,drmazhar,2.33,3,0,3
9332,do you know a few tricks,,lordsheep,1.29,21,-5,16
9331,Multi Reflection.,,drmazhar,3.20,3,0,3
9330,Spiral Out,,leo3065,1.90,4,-2,2
9329,Tiny snake,,lordsheep,1.50,6,-4,2
9328,Crossroads III,,kraker ,3.00,2,0,2
9327,More Reflection,,yurius564,1.90,4,-3,1
9326,Corners's problem.,,drmazhar,2.75,2,0,2
9325,Another speed control II,,drmazhar,3.20,4,0,4
9324,Maia Star,,yurius564,2.88,5,0,5
9323,Crossroads II,,scorpio,3.67,2,0,2
9322,just a simple puzzle,,lordsheep,1.37,28,-7,21
9321,One star hack challenge,,kraker,2.75,2,0,2
9320,waa,,19s5763,2.00,5,-2,3
9319,Linked Squares (Version 6).,,drmazhar,1.67,8,-2,6
9318,What ?? a broken Level !? (Easy Version),,tjandra,1.83,6,-1,5
9317,What ?? a broken Level !?,,tjandra,3.25,1,-1,0
9316,Red Tiles.,,drmazhar,2.36,7,0,7
9315,Aiming at symmetry (but not succeeding),,kraker,3.00,0,0,0
9314,Nested Fraction,,axorion,3.00,6,0,6
9313,Depth First Search Spanning Tree,,tjandra,2.64,6,-1,5
9312,AncientMap:RingOfFire,,asd1,1.91,3,-4,-1
9311,A Hole Didn't Slow Me Down,,tjandra,2.00,2,-2,0
9310,Another1Star?,,asd1,2.14,3,-2,1
9309,TheBluePath,,asd1,1.86,3,-4,-1
9308,Choose the One,,asd1,2.00,2,-5,-3
9307,Circular .............,,drmazhar,1.86,11,-1,10
9306,Counting Black Tiles,,axorion,4.00,1,0,1
9305,Gears,,kraker,2.75,5,0,5
9304,Turning spirals,,scorpio,3.17,5,0,5
9303,hello world,,epic_undead_88,1.25,24,-8,16
9302,Flower,,OlgaLatiy,1.86,15,-3,12
9301,Handcuffs II,,drmazhar,2.09,5,0,5
9300,red way,,OlgaLatiy,1.64,5,-4,1
9299,Green Signs.,,drmazhar,2.25,4,-1,3
9298,Interested frog,,kraker,2.44,5,0,5
9297,Around the Red Line.,,drmazhar,2.00,3,-1,2
9296,Frog,,kraker,2.08,8,0,8
9295,Around The Red.,,drmazhar,2.13,6,-1,5
9294,Pure Reflection.,,drmazhar,1.88,6,-1,5
9293,dk,,19s5763,2.80,5,-2,3
9292,Conditional Statement.,,drmazhar,2.40,6,-1,5
9291,Simple Counting+Simple Cross,,drmazhar,2.10,5,0,5
9290,Ring Around The Rosie,,NinjaCod,1.24,20,-9,11
9289,Special Case of Reflection. (Version 3),,drmazhar,3.00,5,0,5
9288,Left-Right vs Up-Down,,scorpio,3.00,1,0,1
9287,Special Case of Reflection. (Version 2),,drmazhar,3.00,4,0,4
9286,Among holes.,,drmazhar,3.14,5,0,5
9285,colors,,androidhi,1.73,5,-4,1
9284,sing man,,baldrick,1.71,8,-2,6
9283,do some tricks,,epic_undead_88,1.85,4,-6,-2
9282,bbbbbbbbbb,,19s5763,2.08,7,-2,5
9281,Decreasing Curve.,,drmazhar,1.91,5,0,5
9280,don't turn around,,androidhi,1.59,15,-2,13
9279,hard as,,baldrick,1.64,8,-2,6
9278,pac zombie ,,19s5763,2.56,4,-1,3
9277,drip ,,19s5763,2.33,4,-1,3
9276,The Red LINE (Version 2),,drmazhar,2.63,5,0,5
9275,The Red Line,,drmazhar,2.57,5,0,5
9274,Jumping,,drmazhar,2.67,3,0,3
9273,Branches (Version 11),,drmazhar,2.22,5,0,5
9272,Branches (Version 10),,drmazhar,2.20,6,-1,5
9271,Double stacking,,kraker,3.67,1,-1,0
9270,Measuring the stair.,,drmazhar,2.13,5,-1,4
9269,Counting strategies.,,drmazhar,2.22,6,-1,5
9268,stairs loop,,Dark,1.28,55,-12,43
9267,stairs no loop,,Dark,1.36,45,-16,29
9266,?????? ????????,,TimaV,1.84,22,0,22
9265,Paint your puzzle II,,kraker,1.77,8,-1,7
9264,Paint your puzzle,,kraker,4.00,0,0,0
9263,Divergent,,axorion,3.33,4,0,4
9262,Corners of squares II,,scorpio,2.50,1,0,1
9261,meeeh ,,19s5763,1.80,7,-3,4
9260,red paradox ,,19s5763,1.69,6,-1,5
9259,Damping,,drmazhar,2.20,5,0,5
9258,sliced balone,,epic_undead_88,1.83,8,-1,7
9256,Corners of Squares.,,drmazhar,2.29,5,0,5
9255,Backup & Restore (Version 3),,drmazhar,2.33,5,-1,4
9254,1,,dark,1.33,11,-3,8
9253,Harvest,,scorpio,3.00,1,0,1
9252,Laa ,,drmazhar,2.17,1,0,1
9251,Yox,,19s4116,1.69,6,-2,4
9250,Akukho,,19s4116,1.64,8,-3,5
9249,Rectangle+Right-angled trianglea,,drmazhar,3.00,4,0,4
9248,Ring road. (Version 2),,drmazhar,3.33,1,0,1
9247,???????????????,,TimaV,2.07,8,0,8
9246,Spiral of squares,,scorpio,4.00,1,0,1
9245,Mi-NO-sis,,19s4116,1.65,9,-2,7
9244,Data Mining (Version 2),,drmazhar,2.80,3,0,3
9243,Data Mining.,,drmazhar,2.33,5,0,5
9242,A Bet,,19s5763,1.29,15,-6,9
9241,nate potate,,epic_undead_88,1.94,4,-7,-3
9240,Ez,,19s4116,2.00,3,-2,1
9239,Ne,,19s4116,1.58,10,-3,7
9238,Hole finder,,drmazhar,2.67,1,0,1
9237,shoo-be-do-wop,,19s5763,1.71,8,-2,6
9236,Nyet,,19s4116,1.77,6,-2,4
9235,Nein,,19s4116,1.71,8,-3,5
9234,New Look (Version 2),,drmazhar,3.17,3,0,3
9233,t tower,,19s5763,1.73,8,-3,5
9232,Ring road,,drmazhar,3.20,3,0,3
9231,3,,sheep,1.31,14,-3,11
9230,green means go,,sheep,1.29,20,-4,16
9229,trex,,sheep,2.17,10,-2,8
9228,hook,,sheep,1.33,13,-3,10
9227,star power,,Sidhu14,1.47,17,-7,10
9226,Just Let Me Sweep,,axorion,2.60,0,-1,-1
9225,Cards,,drmazhar,1.55,5,-2,3
9224,Square cards.,,drmazhar,1.55,5,-2,3
9223,Replication Engine V (Fractal II),,scorpio,3.00,0,0,0
9222,Replication Engine IV (Fractal I),,scorpio,4.67,3,0,3
9221,Your Making Me Cry,,19s4116,1.69,5,-2,3
9220,Replication Engine III,,drmazhar,3.14,5,0,5
9219,rake,,sheep,1.57,14,-4,10
9217,stairway to heaven,,sheep,1.35,11,-6,5
9215,Different Turns,,itzmal,1.31,34,-5,29
9214,Replication Engine II,,drmazhar,3.17,4,0,4
9213,box them out ,,19s5763,1.79,7,-2,5
9212,Not Again,,19s4116,1.75,8,-3,5
9211,Counting Using the Stack,,itzmal,1.56,11,-4,7
9210,Bottom to Top then Top to bottom,,drmazhar,2.60,2,0,2
9209,New look,,drmazhar,2.67,8,0,8
9208,River,,itzmal,1.46,37,-3,34
9207,2017,,stav2002,1.88,3,-3,0
9206,NO!!!,,19s4116,1.67,7,-3,4
9205,point point break,,19s5763,1.64,7,-2,5
9204,Backup & Restore (Version 2),,drmazhar,2.71,4,-1,3
9203,point break,,19s5763,1.56,8,-2,6
9202,Seriously Just Stop,,19s4116,1.69,2,-5,-3
9201,Minimalism,,axorion,3.25,1,-1,0
9200,Shadow Of The Mountain,,axorion,3.00,0,0,0
9199,Column Chart (Version 4),,drmazhar,2.60,3,0,3
9198,Column Chart (Version 3),,drmazhar,2.75,2,0,2
9197,How recursive can you be,,Si7ius,1.90,7,-2,5
9196,Get the last star,,Si7ius,2.00,19,-1,18
9195,Why Do You Keep Doing This to Us,,19s4116,2.14,6,-2,4
9194,Backup & Restore,,drmazhar,2.91,12,0,12
9193,Please No More,,19s4116,1.79,7,-2,5
9192,No More,,19s4116,1.37,13,-12,1
9191,No,,19s4116,1.33,19,-3,16
9190,Branches (Version 9),,drmazhar,4.00,2,-1,1
9189,Redemption Part II(Shurikin Sequel) ,,slayer,2.33,3,-2,1
9188,LOL V2,,stav2002,1.27,12,-13,-1
9187,Reflection Engineering,,drmazhar,3.00,1,0,1
9186,Branches (Version 8),,drmazhar,3.00,1,0,1
9185,Put signs for yuor ways (Version 7),,drmazhar,3.00,1,0,1
9184,2,,sem8,1.53,9,-3,6
9183,Branches (Version 7),,drmazhar,3.60,3,0,3
9182,Column Chart (Version 2),,drmazhar,2.50,2,0,2
9181,Column Chart,,drmazhar,2.67,4,0,4
9180,Road through red swamps,,scorpio,2.90,8,0,8
9178,kkmk,,joonkyu,1.45,21,-3,18
9177,Half information (Version 2),,drmazhar,1.83,13,0,13
9176,Tank,,sem8,1.36,21,-9,12
9175,Figure out the figure/how to get the star,,483119,1.24,19,-11,8
9174,f2,,sem8,1.79,6,-4,2
9173,Put signs for yuor ways (Version 6),,drmazhar,2.29,4,0,4
9172,creeper,,qwertyuiop2,1.44,9,-3,6
9171,Branches (Versiion 6),,drmazhar,2.20,1,0,1
9170,Branches (Version 5),,drmazhar,3.20,4,0,4
9169,Masr,,drmazhar,2.11,5,0,5
9168,Branches (Version 4),,drmazhar,2.86,5,0,5
9167,Trickster,,itzmal,1.82,15,0,15
9166,Linked Squares (Version 5). ,,drmazhar,3.25,3,0,3
9165,Integral II,,scorpio,3.00,0,0,0
9164,zx as,,kolyamba,1.80,5,-6,-1
9163,gt,,joonkyu,1.48,11,-3,8
9162,Integral,,scorpio,3.10,8,0,8
9161,switch 2,,joonkyu,1.32,11,-3,8
9160,switch,,joonkyu,1.39,7,-3,4
9159,Hole in the middle & Empty corner.,,drmazhar,3.00,0,0,0
9158,A Trip to the Top (Part 3).,,drmazhar,1.90,6,0,6
9157,Only Green and Blue,,drmazhar,3.00,1,0,1
9156,Linked Squares (Version 4) ,,drmazhar,2.83,3,0,3
9155,Linked Squares (Version 3),,drmazhar,2.86,5,0,5
9154,ukolde,,kolyamba,1.57,8,-3,5
9153,Ostrov,,kolyamba,1.44,6,-7,-1
9152,Put sign for your return,,drmazhar,2.67,1,0,1
9151,you must be lost,,483119,1.62,5,-6,-1
9150,Branches (Version 3),,drmazhar,2.25,5,-1,4
9149,Island,,jconcept,1.90,6,-1,5
9148,The boat,,jconcept,1.62,8,-2,6
9147,For the bodybuilding :,,jconcept,1.84,15,-1,14
9146,Branches. (Version 2),,drmazhar,3.50,4,0,4
9145,Branches,,drmazhar,2.71,3,0,3
9144,P3,,Dark,1.82,17,-7,10
9143,P2,,Dark,1.33,17,-6,11
9142,P1 Revisited,,Dark,1.38,25,-12,13
9141,P1,,Dark,1.33,33,-11,22
9140,Problem 1,,Dark,1.32,18,-4,14
9139,A Growing Squares,,drmazhar,2.00,3,0,3
9138,Hardish,,NolyPoly,1.60,2,-6,-4
9137,Watch the Void,,NolyPoly,1.31,23,-4,19
9136,Skip The Hole Mixed with Spiral.,,drmazhar,2.67,2,0,2
9135,Put signs for yuor ways (Version 5),,drmazhar,3.00,2,0,2
9134,Linked Squares (Version 2),,drmazhar,2.50,2,-1,1
9133,Square links,,axorion,2.25,1,0,1
9132,Linked Squares,,drmazhar,2.86,12,0,12
9130,All Stack,,axorion,3.00,4,0,4
9129,LoL,,tosh,1.56,9,-5,4
9128,An easy version of Instruction ID:9105,,drmazhar,2.00,3,0,3
9127,Turnpike,,axorion,3.50,0,0,0
9126,Also Easy,,drwatson,1.41,9,-5,4
9125,Also Easy 1,,drwatson,1.28,16,-5,11
9124,not so easy,,drwatson,2.50,0,-1,-1
9123,not so easy 2,,drwatson,3.20,1,0,1
9122,May be it is a Chines symbol.,,drmazhar,2.38,4,0,4
9121,Redemption,,slayer,2.86,3,0,3
9120,Barrette,,axorion,3.00,0,0,0
9119,Half information,,drmazhar,1.75,5,-1,4
9118,Easy,,tosh,1.28,49,-11,38
9117,Inner Sanctum,,axorion,2.00,2,0,2
9116,Spool 2,,cowans,1.67,0,-2,-2
9115,Spool 1,,cowans,1.71,0,-2,-2
9114,Stairs with Stack,,drmazhar,2.17,2,-1,1
9113,Remember your steps before the first Red,,drmazhar,2.00,6,0,6
9112,JuST BIGiiNiiNG,,tosh,1.25,15,-7,8
9111,Stack with Gross,,drmazhar,2.56,3,0,3
9110,The Zig Zag Road,,drmazhar,2.40,2,0,2
9109,vvv,,ntsr,1.29,36,-9,27
9108,RGB,,drmazhar,2.75,4,0,4
9107,A river meanders... ,,axorion,2.50,4,0,4
9106,Put signs for yuor ways (version 4),,drmazhar,2.60,2,0,2
9105,Instruction,,drmazhar,4.00,2,0,2
9104,STAIRS,,alexvlight,1.34,21,-13,8
9103,Happy New year (2017) (Stack Version),,drmazhar,2.50,1,-1,0
9102,Happy New year (2017),,drmazhar,1.69,6,-1,5
9101,a,,drmazhar,1.67,4,-5,-1
9100,Put Signs for your ways (Version 3),,drmazhar,3.25,2,0,2
9099,Put Signs for your Ways (Version 2),,drmazhar,3.75,2,0,2
9098,Collection of differnt kinds of Puzzles,,drmazhar,2.50,1,0,1
9097,Put Signs for your ways,,drmazhar,3.27,9,0,9
9096,Zoom in ++,,drmazhar,2.14,3,0,3
9095,Zoom Out +-,,drmazhar,1.90,6,-1,5
9093,From Left to Rght & from Right to Middle,,drmazhar,3.00,0,0,0
9092,e,,drwatson,1.53,6,-5,1
9091,Pirate of RoboZZle I,,drwatson,2.00,0,-1,-1
9090,recursion test,,qwertymol,1.44,6,-3,3
9089,Back to Bottom mixed with Xbox,,drmazhar,3.00,1,0,1
9088,"I'm The CEO, huh?",,OxniuM_,1.53,7,-2,5
9087,The 9th Green,,axorion,3.50,0,0,0
9086,Trick of letter A,,DrMazhar,1.70,4,-2,2
9085,Piramidka,,Skaers,1.82,4,-2,2
9084,Summation Version 2,,drmazhar,3.00,1,0,1
9083,Summation,,drmazhar,3.00,0,0,0
9082,Da Windmill,,damien,1.76,13,0,13
9081,Absolute Value,,cowans,3.50,2,0,2
9080,e,,drwatson,1.83,7,0,7
9079,Stack with Stairs,,drmazhar,2.40,1,0,1
9078,my first puzzle,,qwertymol,1.48,13,-5,8
9077,Function calling EX,,Maxim_Visotsky,2.17,6,-3,3
9076,Plag,,Selezenka,1.85,8,-3,5
9075,Easy,,Selezenka,1.62,8,-2,6
9074,Plagiat ,,Selezenka,1.47,8,-3,5
9073,Plagiat ,,Selezenka,1.48,7,-8,-1
9072,...,,Maxim_Visotsky,1.23,30,-15,15
9071,Bit tricker 2,,Selezenka,1.90,6,-2,4
9070,Bit tricker,,Maxim_Visotsky,2.08,6,-2,4
9069,Linked list V,,drmazhar,3.00,2,0,2
9068,Tunnel,,axorion,2.63,3,0,3
9067,Stairs and Icomplete Rectangles,,drmazhar,2.75,2,0,2
9066,Turns,,smylic,?,0,0,0
9065,Vertigo v1.0 alpha,,_Zayac_,1.26,12,-8,4
9064,Super_Pazle,,Sergey_rl,1.26,63,-16,47
9063,My puzzle,,_Zayac_,1.23,33,-9,24
9062,Power P,,Weird,1.87,8,-1,7
9061,Spin wheel ,,Weird,1.90,5,-1,4
9060,Extension Cord,,axorion,2.75,2,0,2
9059,Always turn around on red,,Weird,1.35,18,-8,10
9058,It's simple,,Weird,1.36,19,-9,10
9057,Right on red,,Weird,1.38,13,-2,11
9056,Intersections,,drmazhar,2.00,2,-4,-2
9055,Strange figure,,drmazhar,4.00,1,0,1
9054,Read & implement,,drmazhar,2.83,2,0,2
9053,Dragon ball,,scrubl0rd17,1.50,13,-6,7
9052,Shrek is love,,scrubl0rd17,1.73,3,-6,-3
9051,Function Call/Iteration,,scrubl0rd17,1.67,8,-3,5
9050,<(^_^)>,,scrubl0rd17,2.00,3,-5,-2
9046,Function Call,,mlewisvilla,1.33,20,-13,7
9044,Spring (Selection),,mlewisvilla,1.31,47,-13,34
9043,YYY-YYY,,drmazhar,1.90,3,-4,-1
9042,Spanning the Gaps,,axorion,3.00,2,0,2
9041,Broken Rectifier Jr.,,axorion,3.18,8,0,8
9040,Broken Rectifier,,axorion,3.43,6,0,6
9039,Quotidian Contrivance,,axorion,3.00,2,0,2
9038,Strange Gross,,drmazhar,1.82,3,-4,-1
9037,Homogenise gaps,,drmazhar,1.75,7,-1,6
9036,selection,,jli246,1.86,7,-2,5
9035,function call,,jli246,1.36,10,-10,0
9034,Iteration,,jli246,1.28,81,-16,65
9033,Iteration,,jli246,1.31,39,-16,23
9032,Starzzz,,fercarcyn,1.65,7,-2,5
9031,Selection,,fercarcyn,1.40,8,-7,1
9030,Iteration,,ozorob2,1.33,19,-4,15
9029,Function Calls,,fercarcyn,1.92,7,-2,5
9028,Function call & iteration,,ozorob2,1.20,25,-8,17
9027,Iteration ,,fercarcyn,1.34,28,-11,17
9026,The Flowers,,bpisab23,1.42,23,-6,17
9025,Back and Forth,,Picasso,1.35,13,-5,8
9024,???u s?d do,,bpisab23,2.00,3,0,3
9023,Holiday Invader,,bpisab23,2.00,6,0,6
9022,Function Call Puzzle,,ozorob2,1.27,16,-7,9
9021,Selection & Iteration,,ozorob2,1.38,19,-8,11
9020,Hanging Gardens of Babylon,,bpisab23,1.76,7,-5,2
9019,Selection Puzzle,,ozorob2,1.27,35,-13,22
9018,Box by Box,,engr100,1.63,8,-5,3
9017,Puzzle3,,csproject2,1.71,5,-3,2
9016,Blue Alien Thumbs Up,,bpisab23,2.17,5,-3,2
9015,Selection Trial,,smitty920,1.47,9,-6,3
9014,full of stars,,csproject2,1.67,8,-1,7
9013,puzzle2,,csproject2,2.10,21,-7,14
9012,Title,,engr100,1.79,4,-5,-1
9011,Puzzle2,,csproject2,1.86,6,-3,3
9010,Puzzle2,,csproject2,1.69,5,-3,2
9009,Original,,justenough,1.35,12,-5,7
9008,Selection Puzzle,,fercarcyn,1.26,23,-9,14
9007,Star-Crossed Lovers,,JustEnough,1.45,8,-7,1
9006,Iteration,,seanbarber,1.63,6,-5,1
9005,WHAT LEVEL OF IRONY...,,picasso,1.33,15,-8,7
9004,Forked Lightning,,ablv,1.89,2,-3,-1
9003,U Name it,,justenough,1.31,50,-26,24
9002,Picking daisies,,fespHMSI,2.10,4,-1,3
9001,Shift Pattern,,LarrysLobsters,1.53,5,-7,-2
9000,Cheries,,larryslobsters,1.67,8,-3,5
8999,Broken rectangles (Hard version),,drmazhar,3.00,0,0,0
8998,Combo 2,,jla7,1.59,11,-2,9
8997,Combo 1,,jla7,1.42,9,-6,3
8996,Iteration: Fortress,,vvzjnp,1.60,9,-3,6
8995,Iteration/Selection: Extra Long E,,vvzjnp,1.30,9,-7,2
8994,Iteration/Selection,,vvzjnp,1.38,52,-12,40
8993,star crossed,,csturtles2020,1.86,7,-3,4
8992,oceanic waves,,csturtles2020,1.75,6,-2,4
8991,SnowFlake,,csgroup11,1.83,7,-1,6
8990,obvious but tricky,,csgroup11,1.24,19,-7,12
8988,Mom's udon,,csgroup11,1.72,16,0,16
8987,LOL,,csgroup11,1.30,28,-12,16
8986,Narcos,,csgroup11,2.58,8,0,8
8985,A Whale of a Time ,,larrysLobsters,1.64,8,-3,5
8984,Super turner,,azohra2,1.57,18,-5,13
8983,Cherry,,csturtles2020,1.33,11,-3,8
8982,Braid ,,ablv,1.53,7,-7,0
8981,Selection (Cubes),,jla7,2.00,5,-4,1
8980,compute comute,,vrajsam100,3.00,1,0,1
8979,Basic Selection Puzzle,,aswinrajathesi,1.35,23,-6,17
8978,Function,,seanbarber,1.79,10,-3,7
8977,Engineering at it's finest,,seanbarber,1.71,6,-4,2
8976,Iteration Selection Combo ARHuic,,aswinrajathesi,1.38,7,-6,1
8975,A Toughie,,seanbarber,1.31,61,-20,41
8974,Combination 2,,jwu210,1.38,14,-5,9
8973,Please,,evaque2,1.92,7,-2,5
8972,Function - Iteration ARHuic,,aswinrajathesi,1.38,4,-5,-1
8971,Stairs,,MohamedSaeed99,1.33,23,-5,18
8970,cmw4_5,,cmw4,1.35,44,-11,33
8969,3 Quarters Window,,picasso ,1.90,5,-3,2
8968,Selection UIC,,rhussein,1.60,8,-2,6
8967,Pyramid,,seanbarber,1.50,10,-2,8
8966,cmw4_4,,cmw4,1.56,8,-5,3
8965,Iteration,,evaque2,1.30,8,-9,-1
8964,cmw4_1,,cmw4,1.38,25,-14,11
8963,What's the solution?!,,MJDC,2.40,0,-2,-2
8962,Scary Clown,,MohamedSaeed99,1.58,10,-3,7
8961,cmw4_3,,cmw4,1.35,60,-17,43
8960,cmw4_2,,cmw4,2.11,3,-4,-1
8959,Star Heaven,,kubaaa5,1.34,22,-7,15
8958,Whirlwind,,evaque2,1.64,8,-2,6
8957,Puzzle 5 (Selection),,ggarci54,1.86,6,-4,2
8956,Stairs,,kubaaa5,1.59,8,-5,3
8955,Compass,,fespHMSI,1.50,4,-5,-1
8954,Starry Border,,azuregroup,1.92,7,-1,6
8953,x gonna give it to ya,,azuregroup,1.53,12,-4,8
8952,Travel Around,,azuregroup,1.47,12,-5,7
8951,Puzzle 4 (Iteration/Selection/Function),,ggarci54,1.53,8,-2,6
8950,Space Ship,,ggarci54,2.06,9,-3,6
8949,FlyTheW,,IndianNerds,1.64,7,-2,5
8948,The Hill With A Head Watches All Climbers.,,rhussein,1.75,8,-4,4
8947,Selection and Iteration,,ggarci54,1.53,7,-4,3
8946,Caterpillar,,IndianNerds,1.91,15,-5,10
8945,South Africa,,LarrysLobsters,1.63,8,-1,7
8944,Easier than it looks,,ggarci54,1.53,7,-5,2
8943,Combination Puzzle,,jwu210,1.75,9,-1,8
8942,Iteration UIC,,rhussein,1.67,6,-4,2
8941,Turn around,,azuregroup,1.58,8,-2,6
8940,Team Android,,LarrysLobsters,2.08,7,-3,4
8939,Spotted Horse,,engr100,1.33,9,-12,-3
8938,Function and Iteration UIC,,rhussein,1.77,6,-3,3
8937,?????????,,picasso,1.69,9,-1,8
8936,Function Calling UIC ,,rhussein,1.62,5,-3,2
8935,Candy Cane,,JustEnough,1.88,5,0,5
8934,Sad Frog,,picasso,1.50,7,-3,4
8933,Christmas Colors,,fespHMSI,2.20,3,0,3
8932,Blue Cross Red Square,,JustEnough,1.50,7,-5,2
8931,I <3 CS,,MJDC,1.37,15,-12,3
8930,Crossing a Wall,,Charri5,2.36,4,0,4
8929,Function Calling,,Charri5,1.47,7,-3,4
8928,EU Flag,,Charri5,1.27,40,-11,29
8927,Non-Linear Puzzle,,atverd2,1.56,12,-2,10
8926,Puzzle1,,csproject2,1.32,81,-21,60
8925,Function Calls: Swirly ,,engr100,1.75,10,-3,7
8924,The Colorful Chess Board,,csturtles2020,2.08,5,-5,0
8923,Bird on the Wire,,drwatson,2.13,2,-2,0
8922,Pi ,,IndianNerds,1.48,19,-4,15
8921,Broken recatangles,,drmazhar,2.67,5,0,5
8920,zsdf,,jeajea12,1.90,6,-1,5
8919,fuck ,,limjunghyun,2.00,4,-1,3
8918,Gordian Knot,,axorion,3.50,0,-1,-1
8917,STAIRS,,vvzjnp,1.37,10,-3,7
8916,Functions and looping,,aswinrajathesi,1.73,6,-1,5
8915,Selection Puzzle,,jwu210,1.73,11,-2,9
8914,Selection Puzzle,,vvzjnp,1.64,7,-4,3
8913,Function-Selection,,aswinrajathesi,1.60,4,-7,-3
8912,Iteration,,jwu210,1.27,22,-5,17
8911,No title,,vrajsam100,1.82,5,-2,3
8910,Selection Puzzle,,vvzjnp,1.67,7,-4,3
8909,Function Calls: Puzzle,,jwu210,1.50,8,-3,5
8908,Function Calls,,aswinrajathesi,1.79,7,-5,2
8907,What is this?,,vrajsam100,1.71,8,-2,6
8905,Eyes,,kfong8,1.63,9,-8,1
8904,square^2,,kfong8,1.92,5,-4,1
8903,square^2,,kfong8,1.82,3,-4,-1
8902,How many flights?,,vrajsam100,1.92,5,-4,1
8901,(square)^2,,kfong8,2.00,4,-3,1
8900,Puzzle 2,,vrajsam100,1.83,6,-1,5
8899,Puzzle 1,,vrajsam100,1.85,9,-1,8
8898,s: Pinwheel,,evaque2,1.57,14,-4,10
8897,Loop,,azuregroup,1.83,6,-4,2
8896,Yellow Brick Road,,vvzjnp,1.36,32,-12,20
8895,Selection: Weird Hook Thing,,engr100,1.86,15,0,15
8894,Second Sight,,axorion,2.60,2,-1,1
8893,Unusual H,,drmazhar,2.57,2,-1,1
8892,Color maze,,IndianNerds ,2.29,1,-4,-3
8891,RGB Island,,IndianNerds ,1.50,7,-4,3
8890,Flag,,csturtles2020,1.50,8,-1,7
8889,Space Alien,,MohamedSaeed99,1.54,8,-2,6
8888,Function Tree,,MohamedSaeed99,1.69,4,-2,2
8887,#Hashtag,,MohamedSaeed99,2.50,0,0,0
8886,Extremlytired trip,,drmazhar,2.00,2,0,2
8885,Car 's old hanging system,,drmazhar,2.40,2,0,2
8884,Crooked Bow,,ablv,2.00,5,-1,4
8883,In n' Out,,ablv,1.90,8,-2,6
8882,int 3,,mjdc,?,0,0,0
8881,int 2,,mjdc,1.46,8,-3,5
8880,Int 1,,mjdc,1.78,5,-1,4
8879,caveman,,480513,1.64,7,-1,6
8878,vs bjsdfz,,bjsdfz0208,1.69,6,-3,3
8877,1,,bjsdfz0208,1.55,13,-3,10
8876,aaa,,bjsdfz,1.34,19,-10,9
8875,T,,ablv,1.30,7,-10,-3
8874,Roundabout - Fixed,,fespHMSI,1.86,7,-2,5
8872,idk 2.0,,480513,1.60,12,-5,7
8871,Natural Selection,,fespHMSI,2.00,6,0,6
8870,Roundabout,,fespHMSI,1.71,4,-4,0
8869,Everlastingly....simple?,,fespHMSI,1.67,5,-1,4
8868,Outlining red,,fespHMSI,2.07,6,-4,2
8867,Trial,,nhe3,1.56,10,-3,7
8866,Special case of Reflection,,drmazhar,2.43,4,0,4
8865,Tetris,,MJDC,1.75,9,-2,7
8864,Twisted,,nhe3,2.00,5,-1,4
8863,loom,,kirtapgeno,2.09,4,0,4
8862,Ladder Up and Down,,seanbarber,1.47,9,-2,7
8861,Triceraflops,,axorion,3.50,0,0,0
8860,Iteration,,jla7,2.05,10,-1,9
8859,Good Luck,,atverd2,1.38,23,-9,14
8858,Counting Contiguous,,axorion,3.00,0,0,0
8857,"Up, Left+1,Up,Right+1,....",,drmazhar,3.00,3,0,3
8856,Hardwired ,,axorion,3.00,0,0,0
8855,Pushmi Pullyu Jr.,,axorion,2.50,4,0,4
8854,nhe3 Selection,,nhe3,1.37,24,-15,9
8853,Function Call,,nhe3,1.30,41,-21,20
8852,Iteration,,nhe3,1.27,14,-13,1
8851,Resonances,,drmazhar,2.67,0,-1,-1
8850,Dr. Doolittle's push-me-pull-you,,axorion,3.00,1,0,1
8849,Monuments,,axorion,3.00,0,0,0
8848,Lobotomy ,,axorion,4.00,0,0,0
8847,Lightning Bolt,,axorion,3.00,0,0,0
8846,Pipe Organ,,axorion,3.00,0,0,0
8845,Construction,,drmazhar,2.43,2,0,2
8844,Seizure,,axorion,4.00,0,0,0
8843,Migraine,,axorion,4.00,1,0,1
8842,turn turn turn or burn red,,shyam1610,1.92,8,-2,6
8841,turn red or green fun ,,shyam1610,1.77,7,-2,5
8840,All Blapped Out,,axorion,4.00,1,0,1
8838,plane (for mig chily),,sadiquehaque69,1.57,5,-7,-2
8837,shya iam,,shyam1610,1.75,9,-5,4
8836,sunflwer (DAVID),,sadiquehaque69,1.36,15,-13,2
8835,Lvl 1,,joshuarussell,1.56,8,-6,2
8834,char LIE,,sadiquehaque69,1.58,9,-8,1
8833,Pac mEn,,sadiquehaque69,1.53,12,-2,10
8832,jacksepticeyyyyyyyyyyye pacman ghost,,sadiquehaque69,1.56,7,-8,-1
8831,Blap Jr. II,,axorion,2.50,2,0,2
8830,More red!,,nstei,1.93,5,-3,2
8829,Blap Jr.,,axorion,2.50,1,0,1
8827,Socket Set,,axorion,3.50,0,0,0
8826,Roads & Intresections ,,drmazhar,2.88,4,0,4
8825,BLEP - water tap,,drwatson,3.00,1,0,1
8824,Blap,,axorion,5.00,1,0,1
8823,BLUP,,drwatson,2.70,5,-1,4
8822,Shoe Laces,,axorion,2.67,2,0,2
8821,fire ball,,483119,1.37,17,-6,11
8820,Screeching balloon,,kp16,3.50,1,0,1
8819,Color maze,,neven,1.70,16,0,16
8818,Painting...,,neven,3.50,0,-1,-1
8817,Bounce,,neven,2.36,5,-1,4
8816,Counterparts 2,,axorion,2.50,1,0,1
8815,cccfrfgg,,Bristoche,1.80,8,-1,7
8814,Counterparts,,axorion,2.50,1,0,1
8813,Easy turns,,eversyt,1.65,11,-2,9
8812,E8,,Dimax567,2.17,11,0,11
8811,easy pistol,,363955,2.11,4,-1,3
8810,Smile More,,416646,1.57,9,-2,7
8809,weqdsa,,bjsdfz0208,1.93,7,-2,5
8808,lalala,,bjsdfz0208,1.50,17,0,17
8807,Reciprocating ,,bjsdfz0208,1.90,3,-1,2
8806,CLEVER3,,bjsdfz,1.33,17,-9,8
8805,dark,,bjsdfz,1.85,7,-1,6
8804,CLEVER2,,bjsdfz,1.47,4,-6,-2
8803,CLEVER,,bjsdfz,1.50,7,-2,5
8802,123,,bjsdfz,1.47,7,-9,-2
8801,My First Puzzle,,Robo_Man,1.63,7,-3,4
8800,grid,,Dimax567,1.91,5,-1,4
8799,Portal,,407566,1.36,11,-8,3
8798,Portal,,407566,1.26,16,-11,5
8797,MyPuzzle-Mel,,melp,3.00,1,0,1
8796,snake,,403022,1.47,11,-3,8
8795,cat,,Dimax567,1.61,10,-5,5
8794,The way to the Green Land,,drmazhar,2.43,2,-2,0
8793,mayuxiao love maxuere,,liuxiaojie,1.57,17,-5,12
8792,That is love,,liuxiaojie,1.33,13,-6,7
8791,20,,liuxiaojie,1.30,123,-26,97
8790,hhhhhh,,liuxiaojie,1.35,12,-7,5
8789,10,,liuxiaojie,1.33,78,-29,49
8788,Blop,,axorion,3.00,1,0,1
8787,Pretty hard level,,MAX0,1.83,5,-4,1
8786,the maze,,483119,1.72,9,-8,1
8785,? ????????????,,dskhv,2.17,7,0,7
8784,My First Puzzle,,jwalker_02,1.64,8,-1,7
8783,Sherlock Holmes Faces Death,,drwatson,3.00,0,0,0
8782,Blip,,axorion,3.75,4,0,4
8781,Enjoy Egyption's Pyramids via RoboZZle,,drmazhar,3.25,2,0,2
8780,fk!,,dskhv,2.55,4,-4,0
8779,fk!,,dskhv,2.40,7,-1,6
8778,GCD III,,scorpio,4.00,1,0,1
8777,Back to Bottom,,drmazhar,2.38,5,0,5
8776,Askew,,axorion,2.10,4,-1,3
8775,Trifecta ,,axorion,?,0,0,0
8774,A trip to the top (Part two),,drmazhar,2.17,13,0,13
8772,dk,,joonkyu,1.31,26,-20,6
8771,ck,,joonkyu,1.27,13,-12,1
8770,bk,,joonkyu,1.31,61,-29,32
8769,ak,,joonkyu,1.29,46,-18,28
8768,A trip to the top,,drmazhar,1.50,8,-5,3
8767,for the baby,,483119,1.44,19,-9,10
8766,Trees reflected in the water,,drwatson,3.29,6,0,6
8765,loop the loop,,drwatson,2.86,2,0,2
8764,simple square,,durkinblock,2.33,4,-1,3
8763,Smile it's Deadly if you turn wrong,,Seyje,1.30,48,-25,23
8762,faces,,s306765stu,1.63,8,-4,4
8760,always happy,,483119,1.26,19,-12,7
8759,Woah there,,Kiwi,1.33,9,-6,3
8758,castle,,483119,1.35,16,-7,9
8757,This is the hardest level you will ever see ever,,jenningswilke,1.58,4,-8,-4
8756,KeepMovingForward,,EmperorOfMan,1.61,9,-5,4
8755,Earth,,MarktheBrit,2.18,3,-1,2
8754,bathroom mirror,,drwatson,2.56,4,0,4
8753,The red-hot cat's tail,,drwatson,2.25,2,0,2
8752,Manchurian Candidate,,axorion,2.25,1,0,1
8751,Hypnotechnique,,axorion,3.17,4,0,4
8750,labyrinth,,Dimax567,1.83,6,-2,4
8749,Arouund the Cross,,drmazhar,1.67,5,-2,3
8748,Hypnotic,,axorion,3.00,3,0,3
8747,Estranged,,axorion,4.00,0,0,0
8746,RU Spiral,,SoYman,2.90,5,-1,4
8745,a,,fuck_you ,2.00,5,-2,3
8744,Creepy Crawler,,axorion,3.67,0,0,0
8743,Save Stars from Black Hole,,drmazhar,1.50,7,-6,1
8742,666,,axorion,3.00,12,0,12
8741,Arkanoid - Brick Buster ,,drwatson,2.00,5,0,5
8740,The Escape of the ugly Shark...,,drwatson,2.75,2,-1,1
8739,2 stars 1 jar,,slayer,2.38,3,-3,0
8738,Wide Load,,axorion,3.33,3,0,3
8737,Efficiency 3,,axorion,4.00,0,-1,-1
8736,Efficiency 2,,axorion,3.25,1,0,1
8735,Efficiency,,axorion,2.20,1,0,1
8734,Is it Easy ?,,drmazhar,1.42,10,-3,7
8733,Billiard-Salon,,drwatson,2.27,6,-1,5
8732,Too Many Stars,,416646,1.42,20,-10,10
8731,unfinished,,drwatson,2.60,3,-1,2
8730,Golden Spiral,,drwatson,3.50,1,0,1
8728,Up We Go,,416646,1.31,46,-16,30
8727,Around & Around,,416646,1.29,27,-11,16
8726,Postgraduate ,,axorion,3.00,2,0,2
8725,Blue Flower,,416646,1.53,10,-3,7
8723,Dissertation,,axorion,2.75,3,-1,2
8722,Top down corner version 2,,drmazhar,1.75,6,-4,2
8721,Right Down (UP) Corner of DrMazher 2,,drwatson,1.91,8,-2,6
8720,Right Down Corner of DrMazher,,drwatson,1.77,10,-2,8
8719,skyscraper 2,,drwatson,3.50,0,0,0
8718,Skyscraper 1,,drwatson,2.75,1,0,1
8717,Pit Stop -FormulaDe-,,drwatson,4.00,1,0,1
8716,Conditional Obligations,,axorion,2.60,2,0,2
8715,Right Down Corner,,drmazhar,1.35,6,-9,-3
8714,R there is a stairway?,,drwatson,2.29,4,-3,1
8713,a,,maruska,2.67,0,0,0
8712,marencak,,maruska,1.77,7,-2,5
8711,Turing machine - Potato Duck ;-),,drwatson,2.50,1,-1,0
8710,a,,joonkyu,1.36,28,-8,20
8709,rec,,joonkyu,1.50,14,-3,11
8708,par,,joonkyu,1.52,11,-5,6
8707,rec2,,joonkyu,1.36,12,-6,6
8706,rec,,joonkyu,1.27,13,-6,7
8705,the boomerang,,drwatson,2.67,1,0,1
8704,Gradius -Full Run- ,,drwatson,?,0,0,0
8703,Hedera helix,,android,2.67,3,0,3
8702,One Liner,,axorion,2.85,10,-1,9
8701,the knight's move tree,,drwatson,2.31,6,-1,5
8700,big brother is watching you,,drwatson,3.00,2,0,2
8699,Gooooooooal 3:0,,drwatson,1.77,5,-5,0
8698,Gooooooooal 2:0,,drwatson,1.53,7,-7,0
8697,Turnstyle,,axorion,3.43,4,-1,3
8696,Centipede,,drwatson,2.50,6,-2,4
8695,spiral snail in green,,drwatson,3.00,1,0,1
8694,Deep Sonar Search,,drwatson,2.60,2,0,2
8693,Sonar Search v2.0,,drwatson,2.70,5,0,5
8692,Sonar Search,,drwatson,2.44,4,0,4
8691,The Day of the Tentacle,,drwatson,3.00,0,0,0
8690,The Two Tree Friends,,DrWatson,4.00,0,0,0
8689,creepah,,jrtechcamp2016,1.39,18,-2,16
8687,Gooooooooal ,,drwatson,1.54,6,-4,2
8686,strawberry fields,,drwatson,2.86,3,-1,2
8685,robo head,,jrtechcamp2016,1.50,8,-7,1
8684,This is the house of Santa Claus,,DrWatson,3.33,2,0,2
8682,I know you like it :-),,drwatson,1.79,10,-2,8
8681,Nr. 40 -forty- ,,drwatson,3.00,0,0,0
8680,spiky red reset,,drwatson,3.20,5,0,5
8679,EASY!!!!!!!!!!!!!!,,jrtechcamp2016,1.31,15,-11,4
8678,Tim magraww,,jrtechcamp2016,1.27,34,-19,15
8677,lots of spaces,,jrtechcamp2016,1.50,3,-7,-4
8676,first puzzle,,jrtechcamp2016,2.15,12,-4,8
8675,easy,,jrtechcamp2016,1.44,8,-4,4
8674,fishbone,,drwatson,2.63,5,0,5
8673,Dr.Watson's impossible tentacle technic ,,drwatson,3.20,3,-2,1
8672,a walk by the lake,,drwatson,3.60,2,-1,1
8671,Octopussy,,drwatson,4.00,0,0,0
8670,go around ,,drwatson,2.75,2,0,2
8669,Hit-or-Miss,,slayer,3.00,0,0,0
8668,Happy Solving :),,DexLambo,1.55,13,-2,11
8667,"""Dr.Watson, beam me up !‚",,drwatson,3.50,1,-1,0
8666,Displacement,,axorion,3.00,1,0,1
8665,joonkyu,,axorion,3.25,3,0,3
8664,a,,joonkyu,1.76,6,-7,-1
8663,Aggregates,,axorion,3.00,1,0,1
8662,Over The Hills and Far Away v4.,,drwatson,2.67,2,0,2
8661,wave the magic wand,,drwatson,2.71,4,0,4
8660,silk of a spider ,,drwatson,2.80,4,0,4
8659,Linked List IV,,scorpio,3.00,1,0,1
8658,Polycephaly Snake - it won't bite,,slayer,1.79,8,-1,7
8657,Post Processing 2,,axorion,2.80,4,0,4
8656,Circuit Breaker,,axorion,3.00,1,0,1
8655,jk,,joonkyu,1.63,20,-7,13
8654,30,,drwatson,2.71,5,0,5
8653,Thunderstruck ,,drwatson,4.00,0,0,0
8652,the bee and the flower,,drwatson,?,0,0,0
8651,heavy cross spirals,,drwatson,2.10,4,0,4
8650,heavy cross,,drwatson,2.44,4,-1,3
8649,Post Processing,,axorion,2.80,4,0,4
8648,fuck you,,limjunghyun,1.26,12,-12,0
8647,fuck you,,babosae,2.00,4,-4,0
8646,Fields,,scorpio,2.00,0,0,0
8645,dd,,babosae,2.07,6,-2,4
8644,The only way is up,,neenthewiser,1.31,17,-7,10
8643,PitStop,,Linkuser,1.30,19,-3,16
8642,diamond,,ydavid,2.50,5,0,5
8641,42,,sebdx,2.15,14,-1,13
8640,#11 puzzle,,Shanou,1.92,12,0,12
8639,#10 puzzle,,Shanou,2.23,5,-2,3
8638,LOOP,,drwatson,1.93,8,-1,7
8637,#9 puzzle,,Shanou,1.85,6,-2,4
8636,#8 Puzzle,,Shanou,1.50,15,-2,13
8635,#7 puzzle,,Shanou,1.59,11,-2,9
8634,#6 puzzle,,Shanou,1.45,12,-3,9
8633,Starting Puzzle For Class,,Linkuser,1.38,24,-10,14
8632,#5 puzzle,,Shanou,2.08,8,0,8
8631,#4 puzzle,,Shanou,1.60,14,-2,12
8630,Third puzzle,,Shanou,1.50,10,-2,8
8629,Second puzzle,,Shanou,1.42,7,-5,2
8627,crossroads 3,,astro,3.00,2,-2,0
8626,crossroads 2,,astro,3.00,1,0,1
8625,crossroads 1,,astro,2.50,6,0,6
8624,crossroads 0,,astro,1.65,11,-2,9
8623,Incomplete Hammered,,jin5to,3.57,4,0,4
8622,kolyamba,,kolyamba,1.69,3,-6,-3
8621,kolyamba,,kolyamba,1.65,9,-2,7
8620,kolyamba,,kolyamba,1.69,7,-5,2
8619,kolyamba,,kolyamba,1.79,4,-4,0
8618,Over The Hills and Far Away v3.0,,drwatson,2.00,0,-1,-1
8617,Over The Hills and Far Away v2.0,,drwatson,2.00,1,-2,-1
8616,a,,limjunghyun,1.90,25,-1,24
8615,1000 Jippijippiyeah :-),,drwatson,1.75,6,-2,4
8614,20,,drwatson,2.25,2,-1,1
8613,devox4kids 16 lv4,,level4,1.47,8,-2,6
8612,devoxx4kids 15 lv4,,level4,1.65,11,-2,9
8611,devoxx4kids 14 lv4,,level4,1.73,10,-2,8
8610,devoxx4kids 13 lv4,,level4,1.36,12,-7,5
8609,devoxx4kids 12 lv3,,level3,1.30,34,-12,22
8608,devoxx4kids 11 lv3,,level3,1.53,6,-3,3
8607,devox4kids 10 lv3,,level3,1.37,11,-5,6
8606,devoxx4kids 9 lv3,,level3,1.37,13,-5,8
8605,devoxx4kids 8 lv2,,level2,1.40,15,-4,11
8604,devoxx4kids 7 lv2,,level2,1.29,71,-12,59
8603,devoxx4kids 6 lv2,,level2,1.50,11,-9,2
8602,devoxx4kids 5 lv2 ,,level2,1.47,9,-6,3
8600,devox4kids 3 lv1,,level1,1.29,38,-6,32
8599,devoxx4kids 2 lv1,,level1,1.27,30,-17,13
8597,stack,,limjunghyun,1.38,15,-5,10
8596,The Hardest Puzzle Ever,,wallada,2.00,0,0,0
8595,LOOP-LOOP-LOOP,,drwatson,2.60,2,0,2
8594,4kids-level-5,,milrom,1.32,44,-14,30
8593,4kids-level-3,,milrom,1.38,16,-4,12
8592,4kids-level-2,,milrom,1.27,16,-11,5
8590,Dice v2.0,,drwatson,2.75,3,0,3
8589,Dice. ,,drwatson,2.50,5,0,5
8588,interlaced.,,DrWatson,3.00,1,-2,-1
8587,The Trojan Horse v4.0,,drwatson,2.08,6,-3,3
8586,The Tree v2.0,,drwatson,2.00,2,-3,-1
8585,i forgot,,sebdx,2.24,17,0,17
8584,the tree - test,,drwatson,1.77,6,-1,5
8583,The Trojan Horse v3.0,,drwatson,2.33,0,-1,-1
8582,A Square Deal II,,dorian_gray,2.50,2,0,2
8581,Hard,,jerem923,1.44,10,-4,6
8580,lol,,tazboy13,1.45,14,-4,10
8579,The Trojan Horse v2.0,,DrWatson,2.63,4,-2,2
8578,fu,,jeajea12,1.77,7,-3,4
8577,The Trojan Horse,,drwatson,2.56,3,0,3
8576,Ingo:-) v2.0.,,drwatson,?,0,0,0
8575,The best,,tazboy13,1.55,13,-3,10
8574,Turn `after red` 3,,dorian_gray,3.00,2,0,2
8573,Broken,,softa,3.00,2,-2,0
8572,Subdivisions,,axorion,2.13,7,-1,6
8571,ligtning bolt (medium),,dylane,1.86,6,-4,2
8570,ligtning bolt (easy),,dylane,1.37,22,-11,11
8569,robot meeblie,,dylane,1.50,8,-1,7
8568,Bow And Arrow,,dylane,1.33,10,-7,3
8567,The Gun,,drwatson,2.43,3,0,3
8566,Pit√°gora,,1234alberto,2.00,5,-1,4
8565,checkered,,drwatson,2.14,0,-3,-3
8564,No limit II,,dorian_gray,4.00,1,0,1
8563,Paint a dot in red,,drwatson,2.00,4,-2,2
8562,rocket snail,,drwatson,2.75,0,-1,-1
8561,Doggy,,drwatson,3.67,0,-2,-2
8560,christmastree,,drwatson,2.75,1,-2,-1
8559,Crossroads stones,,scorpio,3.00,1,0,1
8558,Cubes (2nd edition),,scorpio,3.00,1,0,1
8557,Squares,,scorpio,3.00,2,0,2
8556,Numeric rally,,scorpio,5.00,0,0,0
8555,Find the way to the stars...,,drwatson,1.92,6,-3,3
8554,Octopussy,,drwatson,3.00,0,0,0
8553,Brick,,axorion,2.33,3,0,3
8552,Ingo:-),,drwatson,1.91,5,-3,2
8550,Cubes,,scorpio,2.25,1,0,1
8549,Power of 2,,scorpio,3.00,0,0,0
8548,Flip-flop,,MadisonSilver,1.94,13,-2,11
8547,Offset without Red,,k69evil,2.40,8,-2,6
8545,Impossible 4,,fizzlemom,1.85,4,-4,0
8544,Different spirals,,scorpio,4.00,1,0,1
8543,HEY,,8388473,1.56,5,-5,0
8542,Impossible 3,,fizzlemom,2.08,5,-2,3
8541,Impossible 2,,fizzlemom,1.67,14,-3,11
8540,Impossible?,,fizzlemom,1.48,20,-4,16
8539,Jag,,axorion,2.71,5,0,5
8538,Tim's Puzzle #28,,timthree,2.86,6,0,6
8537,Single Lap,,Freakality,1.82,10,-2,8
8536,Tim's Puzzle #27,,timthree,2.00,8,-1,7
8535,Tim's Puzzle #26,,timthree,3.50,0,0,0
8534,Tim's Puzzle #25,,timthree,2.22,4,-3,1
8533,Paint,,cavaloto,1.60,7,-3,4
8532,Trio recurc,,cavaloto,1.75,3,-3,0
8531,Tim's Puzzle #24,,timthree,2.57,4,0,4
8530,Tim's Puzzle #23,,timthree,?,0,0,0
8529,Spider Web 2,,16sreis,1.37,17,-5,12
8528,Tim's Puzzle #22,,timthree,1.80,7,-1,6
8527,Tim's Puzzle #21,,timthree,3.50,0,0,0
8526,Sting,,antonbootsma,2.04,20,0,20
8525,pop,,mat8,1.92,22,0,22
8524,a lot of stars,,mat8,1.94,10,-1,9
8523,Caminho Estranho,,1234alberto,2.40,4,0,4
8522,Rubber Duck,,1234alberto,2.33,0,-1,-1
8521,Quadro Nestical,,axorion,2.89,7,0,7
8520,Tr√™s Ret√¢ngul,,1234alberto,4.00,0,0,0
8519,Target,,1234alberto,1.88,7,-4,3
8518,Fish RGB,,1234alberto,1.88,7,-2,5
8517,Fish RGB,,1234alberto,2.20,6,-1,5
8516,Espiral Azul,,1234alberto,2.22,5,-1,4
8515,Primeiro puzzle,,1234alberto,1.35,25,-3,22
8514,The Firecracker,,Villarreal11,1.83,10,-6,4
8513,Spiral stars,,Villarreal11,1.74,13,-3,10
8512,Stars,,Villarreal11,1.31,90,-34,56
8511,dartboard,,omar112804,1.50,14,-7,7
8510,Quadro Optical,,shaggy12,2.40,5,0,5
8509,CT S01E03,,zarn,1.39,11,-11,0
8508,CT S01E02,,zarn,1.47,8,-7,1
8506,Belarus Flag,,Villarreal11,1.89,11,-4,7
8505,Flip off,,mattelonian,1.46,12,-7,5
8504,Easy Cube,,Villarreal11,1.30,51,-25,26
8503,1,,jkelley8246,1.92,8,-1,7
8502,PROYECTO,,angelemmanuel,1.34,51,-17,34
8501,Go; Go; but not forwward,,vesko465,1.64,10,-6,4
8500,Can you solve it?,,vesko465,1.65,9,-3,6
8499,Just do it!,,vesko465,1.44,16,-6,10
8498,Quadro Floptical,,axorion,3.08,12,0,12
8493,The Third Spiral,,axorion,3.50,7,0,7
8492,Quantum Death: The Fifth Dementia ,,axorion,3.25,2,0,2
8491,What?,,foga,3.29,3,-1,2
8490,Christmas ,,elisa1906,1.44,5,-7,-2
8489,easy,,elva2003,1.38,16,-9,7
8487,eye,,alexiardz2003,1.54,9,-7,2
8485,Teddy ,,marianatp,1.47,4,-7,-3
8484,PROELITE89,,charbel00,2.06,5,-3,2
8482,solucionalo,,andre12,1.52,9,-9,0
8481,PROELITE89,,charbel00,1.65,10,-3,7
8480,Aldo Vidales,,jimmy03,2.11,10,0,10
8478,todo,,salmaherberth,1.55,14,-1,13
8477,Admiral Ackbar,,axorion,3.50,1,0,1
8476,aldo,,aldo02,1.50,8,-8,0
8475,franpollo 2000,,fran2001,1.34,35,-12,23
8474,Thyphlosion,,gabael2002,1.35,6,-10,-4
8473,Easy,,irampcamanuel,1.50,18,-7,11
8471,hola u djofao,,arturo0603,2.13,9,-2,7
8470,666,,melany2001,1.56,9,-6,3
8469,el cambio es el exito,,alex2003,1.53,9,-6,3
8466,Puzzle 1,,smary,1.46,17,-4,13
8463,Oddly Specific II,,rbwnjafurret,4.00,0,-1,-1
8462,"zig, don't zag",,hammerhawk,1.75,3,-4,-1
8461,Cant Believe its not Butter,,igorawrr,2.20,6,-1,5
8460,Almost there,,dadig,1.48,10,-7,3
8457,eazy35,,ricjamesro,1.35,51,-11,40
8455,Trial,,igorawrr,2.36,7,-2,5
8454,Have Fun,,elenah,2.38,2,-2,0
8453,Rocket Man,,jayson1212,1.68,11,-3,8
8451,Keep looking,,rodolfo95,2.40,0,0,0
8450,Iteration,,alopez136,1.56,7,-5,2
8449,Combo 2,,mmvahora,2.00,8,-2,6
8448,Iteration,,mmvahora,1.49,38,-15,23
8447,Group Iteration,,alopez136,1.40,7,-7,0
8446,Loops,,fespproject2,1.71,14,-5,9
8445,dont drop that iteration,,mbauti23,1.55,10,-2,8
8444,iteration puzzle,,fespproject2,1.42,7,-3,4
8441,Crazy Lookin,,rtrieu2,1.32,8,-10,-2
8440,Function Calls 2,,vanberk2,1.29,26,-12,14
8439,Back n Forth,,kreyes26,1.42,9,-4,5
8438,Box Box,,kreyes26,2.36,4,-2,2
8437,Iteration nation,,mbauti23,1.76,5,-5,0
8435,Loops,,kreyes26,1.33,21,-13,8
8434,function calls,,miniproject_2,1.75,7,-4,3
8433,Target Practice,,kreyes26,1.75,6,-4,2
8432,YesNo,,somegroup,2.17,5,-4,1
8431,Many Red Stars... But One Blue,,jblasi3,1.55,12,-4,8
8430,Function Calls,,vanberk2,1.33,14,-9,5
8428,Goodluck - Function Call,,alopez136,1.53,9,-8,1
8427,Stars,,miniproject2,2.13,9,-2,7
8426,Gotta Catch 'Em All,,miniproject2,1.37,33,-13,20
8425,Selection Puzzle CS,,alopez136,2.19,7,-3,4
8424,Cube of Doom,,razgriz4323,1.45,14,-3,11
8419,Colorful Challenge ,,team1,1.42,22,-8,14
8418,FUNCTION CALLS,,team1,1.28,52,-23,29
8417,Function Calls,,jodonn6,1.56,8,-8,0
8416,Circles and Squares,,somegroup,3.20,1,-2,-1
8415,Selection,,team1,1.31,30,-9,21
8414,Project,,team1,1.33,15,-7,8
8413,Hit Every Square,,csbs,2.00,10,-2,8
8410,Funnel,,chabel2,1.72,13,-4,9
8408,Function Calls,,rtrieu2,1.76,7,-5,2
8407,Selection CS111,,rtrieu2,1.53,11,-3,8
8406,Combination Challenge!,,csfresh2019,1.44,11,-2,9
8405,"Big ""G""",,jdelto4,1.83,18,-4,14
8404,Combo Puzzle 2,,jodonn6,1.79,9,-4,5
8401,Get to the Star! v2,,printerm4n,1.71,19,-3,16
8400,Selection and Function Calls,,miniproject_2,1.32,16,-9,7
8399,easypeasy,,miniproject_2,1.44,19,-7,12
8398,Which direction? ,,somegroup,1.53,9,-5,4
8397,LEVEL THREE,,uiccs,1.43,14,-2,12
8396,squares,,lkjadsldsa,1.33,29,-9,20
8395,Iteration,,miniproject_2,1.53,12,-5,7
8394,square,,lkjadsldsa,1.56,6,-6,0
8393,Forward and Backward,,srinivasl,1.53,10,-2,8
8392,Forward and Backward,,srinivasl,1.45,9,-3,6
8391,puzlelellele,,lkjadsldsa,1.86,4,-5,-1
8390,horse,,lkjadsldsa,1.50,7,-6,1
8388,Selection,,fespproject2,1.89,8,-3,5
8387,Green Box,,jdelto4,1.44,33,-6,27
8386,boxes,,lkjadsldsa,1.80,12,-2,10
8385,Green Tiles,,srinivasl,1.50,14,-4,10
8384,Function Calls,,compsci111,1.35,14,-3,11
8383,Pathway,,compsci111,1.30,18,-8,10
8382,LEVEL FOUR,,uiccs,1.67,10,-3,7
8381,aren't I just the Bee's Knees?,,cs111teamben,2.30,3,-3,0
8380,sleeping,,compsci111,2.88,4,-2,2
8379,Let's do the Thyme Warp again!,,cs111teamben,2.67,3,-1,2
8378,Decissions Decissions Decissions,,srinivasl,1.61,8,-3,5
8376,Selection Maze,,tzhou29,2.00,9,-5,4
8375,Puzzle Mix 1,,mmvahora,1.85,5,-3,2
8374,All Concepts - 2,,scody2,2.40,1,-2,-1
8373,Right or Left?,,chabel2,1.63,6,-3,3
8372,Jjeries funtion puzzle,,somegroup,1.26,59,-29,30
8371,Switch Up,,csbs,2.09,6,-4,2
8370,Iteration - 1,,scody2,1.47,9,-4,5
8369,swagstika,,csbs,2.00,8,-2,6
8368,Function Calls - 1,,scody2,1.63,9,-2,7
8367,LEVEL ONE,,uiccs,1.61,11,-5,6
8366,Selection 1,,scody2,1.35,22,-9,13
8365,JacksonP - 1,,scody2,1.55,10,-5,5
8364,Flower,,project_2,2.00,8,-3,5
8363,Challenge Puzzle,,csfresh2019,2.53,14,0,14
8362,Good luck,,csfresh2019,1.79,9,-4,5
8361,Ladders,,cs111teamben,2.20,8,-2,6
8360,back to square 1,,cs111teamben,1.61,13,-2,11
8359,Iteration anf Function Calls,,miniproject_2,1.32,13,-4,9
8358,stairway,,somegroup,1.73,8,-4,4
8357,Function Calls CSZZLE,,cs111,1.33,15,-6,9
8356,Get to the Star!,,printerm4n,1.48,7,-7,0
8355,Function Calls,,mmvahora,1.69,7,-3,4
8354,Fuction uses are Fun!,,printerm4n,1.87,9,-6,3
8353,Group Puzzle 2,,srinivasl,1.50,11,-8,3
8352,Brandon's Puzzle,,srinivasl,1.32,30,-15,15
8351,Super Matches,,jdelto4,1.69,10,-3,7
8350,Iteration - 1,,srinivasl,1.33,64,-17,47
8349,Selection(1),,compsci111,1.58,12,-6,6
8348,iteration,,compsci111,1.29,22,-20,2
8342,lol,,lcasta5,2.29,1,-3,-2
8341,Iteration/Function Calls,,cs111,1.92,8,-3,5
8340,Tp,,fespproject2,1.68,8,-6,2
8339,Function Calls,,lcasta5,1.73,6,-5,1
8338,Iteration Puzzle,,lcasta5,1.36,72,-13,59
8337,Selection,,lcasta5,2.86,4,0,4
8336,Iteration Puzzle,,cs111,1.71,3,-7,-4
8335,LEVEL TWO,,uiccs,2.00,1,-3,-2
8334,Iteration Puzzle,,csfresh2019,1.69,6,-3,3
8333,Using Functions,,csfresh2019,1.79,9,-2,7
8332,Function Puzzle,,csfresh2019,1.53,9,-2,7
8331,Selection Flower,,csfresh2019,1.57,11,-8,3
8330,Combination 2,,ptod,1.33,28,-11,17
8329,Combination 1,,ptod,1.50,7,-8,-1
8326,Round and Round,,jcasto3,1.92,3,-4,-1
8325,Puzzle 1 - Combination,,jodonn6,1.31,40,-21,19
8323,Swing low Sweet Chariot,,cs111teamben,1.72,9,-4,5
8322,Another Selection/Iteration Puzzle,,faap,1.50,6,-5,1
8320,Iteration/Selection,,faap,1.30,57,-13,44
8319,Diamond Puzzle,,faap,1.53,9,-6,3
8318,Selection Puzzle,,faap,2.45,5,-3,2
8317,LEVEL ONE,,uiccs,1.47,7,-9,-2
8316,Spiral,,project_2,1.46,12,-7,5
8314,Deck the Balls,,csbs,1.57,14,-4,10
8313,ecks bawcks,,csbs,1.31,58,-27,31
8312,Spiral ,,fespproject2,2.75,1,-1,0
8311,Dropping landmarks,,jtrinh3,2.38,3,-1,2
8310,Proj3 - Jtrinh,,jtrinh3,2.00,8,-2,6
8309,Spiral,,project_2,1.76,8,-5,3
8308,double tree,,angrevol,3.50,0,-1,-1
8307,Going Full Circle,,project_2,1.79,6,-5,1
8306,Jungle Island,,rbwnjafurret,1.62,17,-3,14
8305,Clockwise and Counter-clockwise,,rbwnjafurret,1.35,44,-7,37
8304,Stars and Stripes,,kyatchma,1.50,14,-5,9
8303,Night-time in the Desert,,rbwnjafurret,1.58,6,-4,2
8302,More Flowers,,rbwnjafurret,1.45,23,-9,14
8301,Switch,,lcasta5,1.44,11,-5,6
8300,very hard radiator,,reinerbaumwoll,2.20,9,-2,7
8299,Winding,,rbwnjafurret,1.79,6,-2,4
8298,Journey of Magellan,,rbwnjafurret,1.75,8,-3,5
8297,Crystal Ball,,rbwnjafurret,1.79,9,-3,6
8296,Drawing the short straw,,shaggy12,2.40,7,-1,6
8295,Pretty Flower,,rbwnjafurret,1.90,10,-4,6
8294,Can you reach the stars? 2,,shaggy12,2.75,4,0,4
8293,Get down get dizzy,,rbwnjafurret,2.07,7,-4,3
8292,Oddly Specific,,rbwnjafurret,?,0,0,0
7292,Domik,,sem8,2.00,9,-2,7
7291,Backtrack,,rbwnjafurret,2.29,5,-2,3
7290,Flip-flop!,,rbwnjafurret,2.08,7,-4,3
7289,Not My First Puzzle,,axorion,2.89,6,0,6
7288,First puzzle,,harrison_pels,1.33,46,-13,33
7287,Maximum Puzzle,,maximum_power,1.94,9,-3,6
7286,My first puzzle,,11msaunders,1.65,12,-5,7
7284,th15 15 2 1337 4 u,,itsallogre4u,2.29,0,-2,-2
7283,lets go,,fox24,2.07,9,-4,5
7282,puzzle 1,,itsallogre4u,2.25,1,-2,-1
7281,apple,,jesse_cabral,2.00,10,-4,6
7280,Aim to stump,,fox24,1.58,16,-5,11
7279,IDK,,gosstheboss,1.81,6,-7,-1
7278,Snurrigt,,softa,3.25,1,-1,0
7277,First Puzzle,,jackson32,1.89,1,-5,-4
7275,Tim's Puzzle #20,,timthree,2.50,0,-1,-1
7274,first puzzle,,jesse_cabral,1.44,16,-8,8
7273,2rwqrq,,john1519,1.89,8,-7,1
7272,Tim's Puzzle #19,,timthree,1.70,13,-4,9
7270,Shuriken with 4 holes,,scorpio,2.50,3,-3,0
7269,4th,,000gjf,1.48,14,-7,7
7267,2nd,,000gjf,2.06,10,-3,7
7265,BA2T,,niro_xd,1.44,16,-7,9
7264,Quest for the red star 4,,onqt,2.83,1,0,1
7263,The mighty X,,semelking,1.84,10,-5,5
7262,Disco stripe,,semelking,1.57,17,-3,14
7261,SPIral,,sem8,1.82,17,-1,16
7260,Division,,babosae,2.83,5,0,5
7259,Multiplication,,babosae,1.56,10,-7,3
7258,Subtraction,,babosae,1.42,13,-13,0
7257,Addition,,babosae,3.06,18,0,18
7256,Tree VI,,edsaw,4.00,4,0,4
7255,Tree V,,shaggy12,3.50,4,0,4
7254,cut the recursion,,jang0617,1.80,13,-4,9
7253,baby,,angelo1244,1.41,15,-11,4
7252,Tree ,,robozziekid,1.77,10,-5,5
7251,mountains,,j613,1.32,76,-19,57
7250,Bumfuzzled ,,axorion,2.71,11,0,11
7249,mission fail,,kevin10,1.46,16,-5,11
7248,"Oops, back again",,myname,2.25,12,0,12
7247,CornerPaint,,myname,2.47,11,-1,10
7246,Stack 2 Test,,omma,2.40,9,-3,6
7245,the face,,robozziekid,2.00,10,0,10
7244,Arkanoid,,scorpio,2.83,5,0,5
7243,Super Red,,robozziekid,2.27,7,-2,5
7242,Easy?,,joshbramfield,2.29,6,-5,1
7241,Windmill,,joshbramfield,1.95,12,-3,9
7240,Tunnel Vision,,joshbramfield,1.58,22,-6,16
7239,Get the Stars 2,,robozziekid,1.76,10,-4,6
7238,Sidetractions,,axorion,3.27,10,0,10
7237,Get the Stars,,robozziekid,1.62,20,-3,17
7235,CAN YOU DEFEAT THIS!?!?!?!,,intenseunicorn,1.50,11,-7,4
7233,MANY LOL,,intenseunicorn,1.32,21,-19,2
7232,Sum logic required,,intenseunicorn,1.28,47,-21,26
7231,Reading stories,,shaggy12,4.50,2,0,2
7230,Skywars,,robozziekid,1.65,12,-4,8
7229,tnttnttnttnttntttnttnttntntntntttnt,,whoun,1.33,54,-33,21
7227,korean boy,,whoun,1.60,13,-3,10
7226,sooa,,ssy6051,1.37,23,-13,10
7225,Approximation,,shaggy12,4.33,2,0,2
7224,Easy recursion,,martinh,1.39,17,-6,11
7223,Pascal's Triangle,,shaggy12,5.00,1,0,1
7222,Big Maze,,scorpio,2.53,13,0,13
7221,wiggle up and down,,cocopino,1.50,19,-4,15
7220,The grass is always greener...,,cocopino,2.00,10,-2,8
7219,Red star quadruped,,cocopino,2.50,4,-2,2
7218,Tim's Puzzle #18,,timthree,2.11,3,-2,1
7217,Primes,,avarga,3.67,4,0,4
7216,Reproduction,,avarga,2.71,6,0,6
7215,Tim's Puzzle #17,,timthree,2.07,6,-1,5
7214,Tim's Puzzle #16,,timthree,2.43,2,-1,1
7213,Tim's Puzze #15,,timthree,2.07,7,-2,5
7212,Binomials,,edsaw,3.50,3,0,3
7211,Tim's Puzzle #14,,timthree,2.10,10,-3,7
7210,Rubber Stamps,,axorion,2.67,5,0,5
7209,Tim's Puzzle #13,,timthree,1.88,27,0,27
7208,Tim's Puzzle #12,,timthree,3.25,1,-2,-1
7207,Tim's Puzzle #11,,timthree,2.47,11,0,11
7206,control turn over,,jbox1,1.59,18,-5,13
7205,Tim's Puzzle #10,,timthree,3.25,1,-1,0
7204,Tim's Puzzle #9,,timthree,1.67,16,-3,13
7203,Equidistant,,axorion,2.86,5,-1,4
7202,Bean Machine,,avarga,2.30,4,-1,3
7201,Scenic Trail,,dtadams,2.21,8,-5,3
7200,Sinister Administer ,,axorion,?,0,0,0
7199,Lost star,,louisn,1.95,10,-3,7
7198,sk3,,milk,1.34,45,-24,21
7195,Candy Cane,,thevoiid,1.74,8,-4,4
7194,LeBox,,tanel,1.29,50,-15,35
7193,"Right on Blue, Too",,dannythorne,2.33,3,-1,2
7189,Q,,kotkas,1.42,14,-11,3
7188,Tanel,,tanel,1.50,10,-7,3
7184,Auxiliary Stack [erratum],,dannythorne,3.40,4,-1,3
7183,Auxiliary Stack,,dannythorne,2.15,4,-4,0
6184,Part,,dannythorne,4.50,2,0,2
6183,Bubbles,,dannythorne,2.43,3,-2,1
5183,Tilt,,dannythorne,2.85,20,0,20
5182,Nine o'clock,,edsaw,3.33,3,0,3
5181,"May, 26th",,mengenlehre,1.39,6,-8,-2
5180,fir-tree 1,,dreadfull_me,2.00,4,-1,3
5179,way around,,dreadfull_me,1.44,28,-8,20
5176,Tolled,,timmycat159,1.46,13,-7,6
5175,Over And Out,,axorion,2.43,5,-1,4
5174,Yin Yang,,rossybossy,1.92,10,-5,5
5172,Colors,,16plee,1.57,31,-8,23
5171,easy,,15efischer,1.34,68,-33,35
5166,Dota 2 like if you like Dota 2/comment,,haydenp1,2.23,22,0,22
5165,Bainiacville,,haydenp1,2.41,9,-2,7
5164,SAWB,,aronquetachris,2.00,6,-7,-1
5162,Lol,,kobi97,1.71,8,-8,0
5161,Round trip III,,marchan,2.45,6,0,6
5160,Use the lonely change tile color thing,,haydenp1,1.31,81,-19,62
5157,Impossible Restitution,,cassavio,2.09,3,-3,0
5156,Thing,,16sreis,2.17,12,-1,11
5155,Good Luck,,tonydabomb1,2.14,4,-4,0
5154,Reaction,,aubreybarry,1.32,21,-14,7
5152,Scooch ,,axorion,4.00,2,0,2
5151,Konami ,,vic6011,1.86,3,-7,-4
5150,Round and Round,,msoko,1.34,39,-14,25
5149,Right Algorithm,,moneyteam,1.95,8,-7,1
5148,Pop Goes The Weasel,,aubreybarry,1.86,5,-1,4
5147,Trial and Error,,jin5to,2.56,3,0,3
5146,tese,,jin5to,2.25,2,-1,1
5145,Chaos,,aubreybarry,1.27,65,-31,34
5144,Fruit Loops 2,,tkiesel,2.40,7,0,7
5142,RGB,,tkiesel,4.00,0,0,0
5140,Fruit Loops,,tkiesel,2.27,5,-1,4
5139,Complementary,,tkiesel,1.67,13,-7,6
5138,Spinner Tree,,tkiesel,2.06,14,-1,13
5137,Split Decision,,tkiesel,1.39,20,-4,16
5136,Use recurence ?,,kirua13390,1.45,15,-10,5
5128,free win ,,worma,1.70,11,-9,2
5124,Tim's Puzzle #8,,timthree,2.07,17,0,17
5123,Tim's Puzzle #7,,timthree,2.06,7,-7,0
5122,Tim's Puzzle #6,,timthree,2.58,8,0,8
5121,Tim's Puzzle #5,,timthree,2.53,9,0,9
5120,Happy New Year 2015,,kirua13390,2.10,23,-1,22
5119,Swap,,actif,1.69,20,-10,10
5118,Double square,,kirua13390,1.64,15,-3,12
5117,Blue or not blue ? That's the question..,,kirua13390,2.13,2,-4,-2
5116,while training,,actif,1.31,64,-11,53
5115,GONNA GET THEM ALL !! ,,kirua13390,1.91,15,-5,10
5114,Little stange cube,,kirua13390,2.14,8,-7,1
5113,Criss cross green-red,,kirua13390,1.89,25,-3,22
5112,Green or blue ?,,actif,1.82,9,-6,3
5111,Care of the green !,,kirua13390,1.72,21,-3,18
5110,Easy beggining,,kirua13390,1.31,81,-31,50
5109,"""You""",,19s4103,1.65,11,-7,4
5108,maga stairs,,davidwaite,1.28,84,-40,44
5107,Easy,,indiapalato,1.27,49,-20,29
5106,Tri Color,,indiapalato,1.31,47,-20,27
5105,red 2,,codymeyer,1.34,65,-34,31
5104,My First Puzzle,,indiapalato,1.32,74,-28,46
5103,Hearth for life,,actif,2.17,11,-1,10
5102,While pratice,,actif,1.60,14,-2,12
5101,4star,,tristinwillett,1.45,37,-9,28
5100,Simple mechanics,,actif,2.60,5,-2,3
5099,Fire,,davidwaite,1.32,77,-31,46
5098,First puzzle,,davidwaite,1.31,177,-35,142
5097,Easy finish,,actif,1.96,11,-8,3
5096,Symetrie mechanics,,actif,2.00,5,-4,1
5095,!!! TRY IT NOW !!!,,kaloyan,2.73,9,-1,8
5094,Eat the blues!,,nstei,3.20,1,-4,-3
5093,DA EASIEST,,isaiahzave2001,1.36,50,-28,22
5092,Stack in tricky spiral,,mike239x,3.00,1,-2,-1
5091,The four islands,,oshabott59,1.55,6,-9,-3
5090,Buck,,oshabott59,1.34,18,-19,-1
5089,Is there a doctor in the house,,oshabott59,1.59,8,-12,-4
5087,easy pickin,,oshabott59,1.32,72,-33,39
5085,cola,,reinerbaumwoll,2.21,5,-3,2
5084,Function Calls Group3 ENGR100,,priyam759,1.61,7,-9,-2
5082,Selection Puzzle Group3 ENG100,,priyam759,1.33,40,-18,22
5081,unbalanced challenge,,zqpmz585,1.34,44,-16,28
5079,Selection ,,mambonumber5,1.70,11,-5,6
5078,TEAM81'S SNAKE,,team81,2.08,7,-5,2
5077,Complicated 2,,arbaaz7866,1.77,12,-9,3
5075,Cherry xmas,,uicengr1000,1.68,11,-5,6
5074,Ocarina T50,,uicengr1000,1.54,18,-7,11
5073,Egyptian Pinnochio T50,,uicengr1000,1.71,4,-6,-2
5072,K.,,uicengr1000,1.33,26,-10,16
5070,Team5_Robot,,mambonumber5,2.00,4,-5,-1
5069,team5_x,,mambonumber5,1.38,29,-8,21
5068,Team5_Spirals,,mambonumber5,1.66,32,-2,30
5067,selection,,team2sdm,1.48,15,-3,12
5066,Stack Encryption ,,axorion,2.71,3,0,3
5065,Selection,,kingdom,1.44,15,-7,8
5064,Have fun 2,,team2sdm,2.22,9,-4,5
5063,Have fun,,team2sdm,2.00,10,-9,1
5062,mix 2,,group4project2,1.78,12,-2,10
5061,Selection,,group4project2,1.48,16,-8,8
5060,group 4 iteration ,,group4project2,1.56,12,-5,7
5059,group 4 interation,,group4project2,1.61,10,-4,6
5058,group 4 mix ,,group4project2,1.43,13,-3,10
5057,Complicated,,arbaaz7866,2.26,10,-5,5
5054,Selection,,zammy_j,1.70,14,-3,11
5053,Cuttin' Crops,,kingdom,2.63,0,-3,-3
5048,challenge#2,,team20,1.34,25,-9,16
5046,cricket bat,,11186,1.35,16,-6,10
5045,Broken Bullseye,,kingdom,1.89,1,-1,0
5044,Challenge#1,,team20,1.78,11,-4,7
5043,Iteration,,team20,2.21,6,-2,4
5042,Function Calls,,team20,1.31,36,-12,24
5041,Ring,,zqpmz585,1.53,20,-5,15
5040,call me maybe,,group4project2,1.83,12,-4,8
5039,STARS EVERYWHERE!,,mikektday,1.70,12,-8,4
5038,selection,,team20,1.30,43,-14,29
5037,Selection,,group121 ,1.56,17,-6,11
5036,Count Green before Blue,,qinn,4.33,2,0,2
5034,Intended as every other square,,softa,3.00,0,-1,-1
5033,Iteration//,,ionvoc6,1.90,8,-9,-1
5030,ENGR 100 Loop 3,,group121,1.65,15,-8,7
5029,Red Path,,vitalstatistic,3.40,1,-2,-1
5028,Team6_Challenge#2,,idiaz19,1.44,17,-11,6
5027,Team6_Challenge#1,,idiaz19,1.31,85,-30,55
5026,Team6_FunctionCalls,,idiaz19,1.48,16,-3,13
5025,Team6_Looping,,idiaz19,1.94,11,-3,8
5023,Mix1_Kunal,,group121,1.67,11,-10,1
5021,Sweep away 5,,marchan,2.31,21,0,21
5020,Paint The Town Red,,soviet_potato,1.39,16,-10,6
5019,ENGR 100 Loop 2,,group121,2.05,11,-5,6
5017,Loop,,group121,1.64,15,-9,6
5016,Tommt Wommy,,carterkrei,1.31,95,-60,35
5015,Reverse,,beastteam,1.42,15,-6,9
5014,random testing,,mikektday,1.35,14,-11,3
5013,iteration,,team81,1.30,39,-15,24
5012,Red Field 1.2,,wanja3,1.65,15,-4,11
5010,Recursionnnnnnn,,zqpmz585,2.14,16,-1,15
5009,Not as hard as it looks,,arbaaz7866,1.46,20,-5,15
5007,lakotas x-mas,,4829,1.33,27,-18,9
5006,lakotas confustion,,4829,1.48,23,-11,12
5005,Color Functions,,beastteam,1.60,13,-7,6
5004,Glitch,,beastteam,1.86,16,-6,10
5000,lol,,trihicks,1.67,9,-9,0
4996,Iteration/FunctionC,,team2sdm,1.90,2,-6,-4
4995,ENGR100T32P3,,team32,1.86,11,-6,5
4994,ENGR100T32P2,,team32,2.20,13,-4,9
4990,lakotas green puzzle,,4829,1.71,11,-8,3
4989,Right Path,,vitalstatistic,3.00,1,-3,-2
4988,lakota cunfustion,,4829,1.70,10,-6,4
4987,red and green ,,ionvoc6,1.26,27,-17,10
4983,Hourglass,,mikektday,2.09,13,-2,11
4982,Whirl,,orlando_l,2.15,18,0,18
4981,Aztec pyramid (Sweep away 4),,marchan,3.22,7,0,7
4980,Just go for it,,wesley_mays,1.40,42,-13,29
4977,simple,,brynjamin,1.34,46,-17,29
4976,I love TIC,,daichi,1.71,9,-6,3
4975,Thing.,,mikektday,2.67,1,-4,-3
4973,trail,,dabearsrule,1.79,8,-10,-2
4972,stars,,butterflylover,1.33,30,-18,12
4971,crazy fun,,puppylover13,1.34,23,-8,15
4970,THE HAPPY PUZZLE,,wendylawson,1.29,136,-64,72
4969,popcron,,wendylawson,1.31,50,-31,19
4967,delaney is the meanest ever,,holdenwyrick,1.34,54,-31,23
4961,andrew is awesome,,patty37,1.77,9,-11,-2
4960,holden1,,cmeadows34346,1.33,30,-11,19
4957,Wombatty Puzzle,,tommywombat,2.00,11,-5,6
4956,square yes,,brynjamin,1.41,15,-10,5
4955,Torn,,android,1.90,1,-4,-3
4954,Triforce,,mikektday,1.87,12,-4,8
4953,Try to solve ,,wesley_mays,1.96,9,-10,-1
4952,Until red,,marchan,2.92,22,0,22
4950,Cross,,85552019,1.29,43,-15,28
4947,loop,,rhys,1.87,8,-5,3
4946,Count up,,marchan,3.08,9,0,9
4944,trystson t,,dabearsrule,1.30,23,-16,7
4943,chicago c,,dabearsrule,1.43,12,-11,1
4942,around and around,,dabearsrule,1.55,9,-12,-3
4941,Solve It if u can,,samrocks,1.45,21,-14,7
4940,There and Back Again and Again,,troy,1.40,33,-12,21
4939,Engineering,,darqfall,2.32,4,-8,-4
4938,Symmetry - Spiral Painting 4,,shaggy12,3.00,2,0,2
4937,Symmetry - Spiral Painting 3,,shaggy12,3.00,3,0,3
4936,Sweep before cross,,marchan,3.06,15,0,15
4935,Easy peasy for begginers,,toxicswirlypop,1.35,68,-28,40
4934,LIFO to FIFO 2,,edsaw,3.14,6,0,6
4933,It's in memory,,doublemx2,3.29,4,-2,2
4932,Endless,,gsanchez10,1.55,17,-9,8
4929,Of 2 Minds,,doublemx2,3.67,2,0,2
4928,1.54535E+29,,elysse,1.47,18,-13,5
4927,Geen...or Red?02,,gsanchez10,2.12,9,-6,3
4926,stair steps,,elysse,2.65,9,0,9
4924,Lol,,elysse,2.12,8,-9,-1
4923,Groove Coverage V,,shaggy12,3.50,3,0,3
4922,Green... or Red?,,gsanchez10,2.06,9,-5,4
4921,Balanced Ternary,,sticky,3.25,1,0,1
4920,Two Faces,,andressomer02,1.32,23,-15,8
4918,Two Stripes,,andressomer02,1.44,13,-12,1
4917,Maze,,andressomer02,2.60,3,-2,1
4915,Algebra,,marchan,3.23,9,-1,8
4914,Surplus,,marchan,3.50,3,-1,2
4913,cute,,jokey,2.67,16,-1,15
4911,Navi Down,,darkchowder,2.09,3,-7,-4
4910,The Wiggle Room,,axorion,2.25,5,-1,4
4909,Peartree,,lysis,2.50,8,-1,7
4908,what?,,jokey,2.40,15,0,15
4907,cxcxvxvxv,,jokey,2.13,10,-2,8
4906,lol,,jokey,1.34,31,-18,13
4905,asdasdasd34,,jokey,1.86,6,-8,-2
4904,Symmetry - Stack,,shaggy12,3.25,5,0,5
4903,bucle,,rodolfo95,1.59,16,-7,9
4902,Turn and go,,kordalia,3.25,2,-3,-1
4901,asdasd23,,jokey,1.53,17,-12,5
4900,Symmetry ‚Äî Random Pai,,smylic,3.17,5,-1,4
4899,My first maze,,kordalia,2.15,50,0,50
4898,asdasdasd,,jokey,1.45,19,-9,10
4897,Thirteen ,,axorion,2.64,8,0,8
4896,asd2,,jokey,2.26,16,-1,15
4895,asdef,,jokey,2.16,12,-7,5
4894,Escapement,,axorion,3.80,3,-1,2
4893,Up-and-down,,marchan,2.80,3,0,3
4892,Preparations,,marchan,2.79,11,-2,9
4891,Sweep away 3-1,,marchan,3.40,3,-1,2
4890,Reflection V,,qinn,3.40,3,0,3
4889,Sweep away 3,,marchan,3.13,6,0,6
4888,Out Of Phase,,axorion,3.00,3,0,3
4887,ese2,,nikipav,1.42,27,-13,14
4886,Can't Solve Yours,,axorion,3.00,2,-1,1
4885,flooding diamond,,wiwagi,2.85,7,-5,2
4884,Navigation,,shaggy12,3.80,4,0,4
4883,Sparkles,,dannythorne,2.38,3,-1,2
4882,Short Circuit,,shaggy12,3.20,4,0,4
4881,Transparent red,,marchan,3.33,6,-2,4
4880,Restart on green,,marchan,2.83,1,0,1
4879,Splat!,,axorion,3.09,7,-1,6
4878,Fetch,,shaggy12,3.83,4,0,4
4877,Constrangled,,axorion,3.67,2,0,2
4876,Stalactites II,,shaggy12,3.00,1,-1,0
4875,Green junction 3,,axorion,3.38,6,-1,5
4874,Green junction 2,,marchan,3.30,7,0,7
4873,chees,,cendajizek,1.55,16,-2,14
4871,little devil,,cendajizek,1.86,10,-10,0
4870,Offsett 2,,axorion,3.56,4,-1,3
4869,little angel,,cendajizek,1.85,9,-10,-1
4868,Offset,,axorion,2.64,12,0,12
4867,six towers,,cendajizek,2.33,10,-4,6
4865,Green junction,,marchan,3.21,11,-1,10
4864,goblin's spiral,,cendajizek,1.48,19,-8,11
4863,702098003,,702098003,1.72,10,-10,0
4862,Symmetry,,cendajizek,2.67,8,0,8
4861,spider's spiral,,cendajizek,1.40,27,-7,20
4860,spider man,,cendajizek,1.49,18,-14,4
4859,Cross,,rodolfo95,1.61,20,-7,13
4858,star car,,cendajizek,2.03,22,-1,21
4857,f,,boydstar,1.60,26,-13,13
4856,Sweep away 2,,marchan,2.80,1,0,1
4855,Sweep away,,marchan,2.56,6,-1,5
4854,Hakuna Matata,,axorion,2.82,7,0,7
4853,"Don't worry, be happy",,akavari,2.31,13,0,13
4852,Cake,,mjcizek,1.70,14,-4,10
4851,cendajizek's chellange,,cendajizek,1.38,41,-18,23
4850,roler coster,,cendajizek,1.83,17,-6,11
4849,Dinosaur - Challenge!,,akavari,2.44,3,-1,2
4848,Dinosaur,,akavari,2.00,8,-2,6
4846,Step and turn 2,,rodolfo95,1.74,17,-3,14
4844,Pluck the pettles,,akavari,2.63,11,-1,10
4843,Iterating 2.0,,akavari,2.00,9,-2,7
4842,Turning point 2,,marchan,3.13,6,0,6
4841,star paint,,mjcizek,1.34,42,-25,17
4840,Azi,,nikipav,1.56,18,-8,10
4839,Hop Trop,,nikipav,1.57,23,-5,18
4838,Tomato picking 2,,marchan,3.14,6,0,6
4837,Eel,,shaggy12,2.35,27,0,27
4836,Vice Versa,,akavari,2.06,4,-5,-1
4835,Iterating,,akavari,1.45,24,-8,16
4834,Tomato picking,,marchan,2.91,10,-1,9
4833,Forward and turn,,marchan,3.17,4,0,4
4831,My 8,,lordlps,1.58,13,-9,4
4830,Why,,fiskurtjorn,2.23,3,-3,0
4829,Split Decision,,shaggy12,3.33,5,-1,4
4827,Sea of Blue,,11038,1.33,18,-11,7
4826,Key,,daneel,1.57,19,-5,14
4825,Turn before U-turn,,marchan,3.20,4,-1,3
4824,Treasure Map,,mathandcarnage,3.00,5,-2,3
4823,Lambda,,lordlps,2.17,11,-4,7
4822,Blue lagon,,lordlps,1.36,43,-15,28
4821,Diamond In The Rough,,axorion,2.50,4,0,4
4820,On the border,,lordlps,2.00,16,-2,14
4819,Northeast and NSEW,,marchan,3.25,4,-1,3
4818,Turn after U-turn,,marchan,2.83,4,0,4
4817,How many turns,,marchan,2.60,9,0,9
4816,Next direction,,marchan,3.00,1,0,1
4815,switch,,happy_face,1.96,12,-5,7
4813,swirlies,,happy_face,1.39,33,-10,23
4812,hello,,happy_face,2.00,15,-3,12
4811,nesting,,j3e8,1.94,10,-3,7
4810,Rift III,,qinn,5.00,2,0,2
4809,sfcs,,ilikebacon22,1.80,16,-11,5
4808,snail,,nesinn,4.00,1,0,1
4806,3√ó,,mohammadhm,1.55,23,-11,12
4805,box,,nesinn,1.96,9,-5,4
4804,:),,ilikebacon22,1.49,22,-8,14
4803,Red carpet,,marchan,2.83,5,0,5
4802,The Bloddy Mummers,,lou42,2.67,9,0,9
4801,Jaime,,lou42,3.33,1,-4,-3
4799,King Joffrey,,lou42,2.83,1,-4,-3
4798,painting and switching,,kenniky,1.77,15,-8,7
4797,Triangle,,shaggy12,4.25,3,0,3
4796,Easy one,,shaaris,1.48,22,-8,14
4795,My 1st puzzle,,shaaris,1.48,22,-8,14
4794,the cube,,dearcornbm,1.32,64,-30,34
4793,Cersei,,lou42,4.00,0,0,0
4791,4 stars,,mordeth,2.00,12,-3,9
4790,Quite easy 2,,mordeth,1.90,10,-5,5
4789,Promotion to a knight,,marchan,3.25,2,0,2
4788,Just stack ? 2,,mordeth,3.00,1,-2,-1
4787,Reek,,lou42,3.00,0,-2,-2
4786,Quite easy,,mordeth,1.59,18,-8,10
4785,Just stacks ?,,mordeth,2.78,5,0,5
4784,Simple Coding II,,xxdzs3,1.77,3,-6,-3
4783,Simple coding,,xxdzs3,2.30,15,0,15
4782,FUN (^_^),,mohammadhm,4.00,2,-1,1
4781,Roboduction,,axorion,3.00,6,-4,2
4780,Rift II,,shaggy12,4.25,4,0,4
4779,Cantilevers,,axorion,3.00,17,-1,16
4778,Boogie Woogie,,lou42,1.72,15,-4,11
4777,Parabola III,,shaggy12,4.50,2,0,2
4776,Top Hats,,axorion,2.50,1,0,1
4775,spiral,,welter,1.54,41,-15,26
4774,Swept Away,,axorion,2.27,18,-1,17
4772,tic-tac-toe board,,welter,1.85,10,-6,4
4771,block,,welter,1.47,18,-7,11
4770,Shagga son of Dolf,,lou42,2.64,6,-1,5
4769,I know I know oh oh oh,,lou42,2.55,6,-2,4
4768,The King In The North ,,lou42,2.50,5,-2,3
4767,21 little frogs,,lou42,2.29,1,-4,-3
4766,13 litte pigs,,lou42,2.10,3,-3,0
4765,????2,,mohammadhm,1.42,50,-13,37
4764,????,,mohammadhm,1.35,64,-17,47
4762,broken spiral,,welter,1.71,10,-5,5
4761,6 stars,,welter,1.31,47,-23,24
4760,ignore the checkers,,welter,1.26,65,-25,40
4759,stars in the corners,,welter,1.35,34,-21,13
4758,Space Holes!!!,,mohammadhm,5.00,0,0,0
4757,Purposely Perplexed,,axorion,3.00,2,0,2
4756,Chromatic Whirl,,shaggy12,4.80,4,0,4
4755,"green to red, red to green",,softa,2.30,3,-5,-2
4754,Interstack 2,,leo3065,4.33,0,-2,-2
4753,Interstack,,leo3065,?,0,0,0
4752,which way?,,softa,2.88,4,-1,3
4751,Smiling eyes,,softa,2.80,4,-1,3
4750,Thread the Needle,,axorion,3.33,9,0,9
4749,Easy...,,z423x5c6,1.51,34,-6,28
4748,Alternate Stacks,,xxdzs3,1.78,17,-6,11
4747,T9,,softa,2.25,5,-6,-1
4746,Narrow Road,,darkchowder,3.00,4,-1,3
4745,Flower!,,master_robot,1.42,64,-25,39
4744,Expertnential,,avarga,2.36,9,-1,8
4743,Xmas River,,avarga,4.00,0,0,0
4741,Snake,,darkchowder,2.88,12,0,12
4740,Binary Addition (16-bit),,wallacoloo,2.83,2,-1,1
4739,Outline Golf,,avarga,1.51,24,-9,15
4738,Four Corners Golf,,avarga,1.60,11,-8,3
4736,Precarious Path,,darkchowder,2.27,11,0,11
4735,Damaged Ship,,darkchowder,2.45,8,-2,6
4734,X,,wallacoloo,2.55,10,-1,9
4733,Think About It,,fikesn,1.52,35,-17,18
4732,Leap of Faith,,darkchowder,2.82,7,-1,6
4731,Changing Tracks,,darkchowder,1.91,17,-2,15
4729,Painting Stairs,,darkchowder,2.13,9,-3,6
4728,Stapler,,darkchowder,1.51,28,-7,21
4727,Stacks on Stacks on Stacks 2,,avarga,2.33,3,-1,2
4726,Stacks on stacks on stacks,,avarga,2.17,12,-4,8
4725,Zen spiral,,dtadams,2.81,21,0,21
4724,Mission Impossib-L,,dtadams,2.62,6,-3,3
4722,To make a green world,,d3r1,2.10,15,-3,12
4721,Left and right,,d3r1,1.65,16,-9,7
4720,This is easy,,petersenin,1.31,75,-28,47
4719,Turn and return,,d3r1,1.92,17,-3,14
4718,Tree,,d3r1,2.00,12,-4,8
4717,Map,,d3r1,1.82,10,-4,6
4716,Nested Resonance Amplifier 2,,axorion,2.83,11,0,11
4714,Repaint!,,evilginger,1.75,20,-7,13
4713,Zombie mario,,d3r1,1.66,42,-13,29
4712,Nested Resonance Amplifier,,axorion,2.21,11,0,11
4711,Mystery Image 3,,jamesverheyden,1.31,116,-33,83
4710,Mystery Image,,jamesverheyden,1.64,36,-6,30
4709,CACO,,jamesverheyden,1.53,30,-15,15
4708,Bridges,,jamesverheyden,2.33,5,-3,2
4707,some thing,,miraaj,1.46,37,-15,22
4706,Right and left by OreoDunkins,,oreojunkins,1.40,46,-16,30
4705,Oreo Dunkins 1st puzzle,,oreojunkins,1.43,27,-11,16
4704,EASY COOL,,petersenin,1.34,52,-16,36
4703,Easy Puzzle,,master_robot,1.42,43,-17,26
4702,1.0101E+15,,mohammadhm,2.07,8,-4,4
4701,Story Hosrse,,mohammadhm,1.88,4,-4,0
4700,Read instructions,,jiro,?,0,0,0
4699,Intersection Interaction,,axorion,2.75,1,0,1
4698,Much and Many,,shaggy12,3.50,2,0,2
4697,Trees - Heights,,shaggy12,3.00,2,0,2
4696,Dumbbell,,marchan,2.75,5,0,5
4695,Worm in Worm,,mohammadhm,2.18,12,-2,10
4694,Damped signal 2,,jiro,3.00,2,0,2
4693,Parabola II,,shaggy12,5.00,1,0,1
4692,Painted Line Symmetry,,masterluk,3.25,1,-1,0
4691,Around the square,,jiro,2.53,9,-1,8
4690,As Easy As ABC,,mohammadhm,1.64,29,-15,14
4689,Limitations,,masterluk,2.50,12,0,12
4688,Word,,axorion,2.77,8,-1,7
4687,M,,mohammadhm,2.22,9,-3,6
4685,Danser,,mohammadhm,2.56,6,-2,4
4684,Block,,mohammadhm,1.44,37,-15,22
4681,Central 2,,heroclixer,1.59,17,-4,13
4680,crazy towers,,miraaj,1.34,39,-19,20
4679,Window and a Thing,,miraaj,2.50,3,-4,-1
4678,Listener,,mohammadhm,2.33,6,-4,2
4677,Directed Panels,,masterluk,3.25,1,-1,0
4676,Pass and turn 3,,marchan,2.83,4,-1,3
4675,"Symmetry - Right on Green, Left on Red",,shaggy12,3.40,4,0,4
4674,EASiest,,mohammadhm,1.46,24,-11,13
4672,Advanced Signal,,shaggy12,3.67,2,0,2
4671,R-L-SG,,mohammadhm,1.63,42,-9,33
4670,6-load accumulator,,jiro,3.50,1,0,1
4669,Harmonic signal,,jiro,2.58,6,-1,5
4668,Pass and turn 2,,marchan,3.25,16,-1,15
4667,Forest Pathway,,shaggy12,2.63,10,-1,9
4666,Square root,,shaggy12,2.60,3,0,3
4665,Pass and turn,,marchan,2.67,1,0,1
4664,;-),,mohammadhm,1.67,21,-8,13
4663,Damped signal,,jiro,3.33,8,0,8
4662,--|>,,mohammadhm,1.86,7,-4,3
4661,Red & blue,,benoke98,1.86,17,-4,13
4660,Early Stacking,,shaggy12,3.60,5,0,5
4658,Full ring,,jiro,1.70,10,-11,-1
4657,Red & green,,benoke98,2.69,11,0,11
4656,Collect all with 3 short functions,,benoke98,1.42,50,-11,39
4655,:0-,,mohammadhm,1.55,27,-8,19
4654,Rabbit Hole,,dannythorne,3.00,1,-4,-3
4653,9 decisions,,mohammadhm,2.67,0,-2,-2
4652,Building Up,,dannythorne,2.08,7,-3,4
4651,Going Up,,dannythorne,2.46,10,-2,8
4650,ermmm,,avi1223,1.38,36,-18,18
4649,:),,mohammadhm,1.47,49,-9,40
4648,19.96,,mohammadhm,1.56,39,-11,28
4646,Ballistic shot 3,,jiro,2.47,8,-4,4
4645,Turn and pass 2,,marchan,2.86,4,0,4
4643,Ballistic shot,,jiro,2.00,9,-8,1
4642,Ballistic bounce,,jiro,3.25,1,-2,-1
4640,Step and turn,,rodolfo95,2.08,9,-6,3
4639,Turn and pass,,marchan,3.10,20,0,20
4638,Balistic bounce,,jiro,1.86,8,-10,-2
4637,BarBari,,mohammadhm,2.60,2,-2,0
4636,Be an artist!,,onqt,2.50,1,-3,-2
4635,T,,mohammadhm,3.00,3,-3,0
4634,Seesaw game,,marchan,5.00,0,0,0
4633,Like,,mohammadhm,1.56,15,-5,10
4632,Stalactites I,,shaggy12,3.00,1,0,1
4631,Nine,,axorion,2.33,3,0,3
4630,Monte-Carlo,,jiro,2.27,8,-2,6
4629,big cheat from MHM,,amirabbas,1.39,23,-14,9
4628,hi,,carters1,1.69,20,-5,15
4627,trust in colors ,,kotake,2.00,12,-3,9
4626,Doctor Who,,thomoi,1.50,32,-12,20
4625,Rainbow,,mohammadhm,1.72,20,-7,13
4624,1/2/2003,,jiro,3.43,2,-2,0
4623,Like or Dislike???,,tiyo,2.75,10,-3,7
4622,special shuriken,,kotake,2.00,18,-4,14
4621,not hard,,kotake,1.35,53,-12,41
4620,less technical,,kotake,1.87,11,-9,2
4619,alien mario,,kotake,3.00,4,-5,-1
4618,some technical,,kotake,2.78,3,-3,0
4617,Sorting VII,,edsaw,4.67,1,0,1
4616,Second first prop,,tiyo,3.40,2,-2,0
4615,first prop,,tiyo,2.50,11,-3,8
4614,1st puzzle,,kotake,1.69,20,-6,14
4613,Symmetry - Line Scan,,edsaw,4.00,4,0,4
4612,Sunset Key (not Tank Island),,dannythorne,3.00,4,-1,3
4609,Cardio,,shaggy12,3.00,3,0,3
4608,The man with one red shoe,,shaggy12,2.60,7,0,7
4607,Marked Bridges Reverse,,qinn,3.18,12,0,12
4606,Hole in One,,masterluk,3.06,12,0,12
4605,Marked Bridges,,qinn,2.81,29,0,29
4604,Shorter Fourshortened,,edsaw,3.17,4,0,4
4603,Fourshortened,,axorion,2.86,3,0,3
4602,Realign 2,,dannythorne,5.00,0,0,0
4600,One More Green,,masterluk,3.50,4,0,4
4599,A Different Perspective,,edsaw,3.31,11,-1,10
4598,red and blue alien,,wiwagi,3.40,1,-3,-2
4597,Perspective,,axorion,3.31,11,0,11
4596,Realign,,carykh,3.00,1,0,1
4595,criss cross,,robotek,1.47,15,-13,2
4594,Apricot Picking,,carykh,3.25,14,0,14
4593,Image Copier,,carykh,3.17,12,0,12
4592,Langston's Ant,,carykh,2.45,2,-6,-4
4591,Red Execution Thread - Stack Order,,masterluk,?,0,0,0
4587,Creepy Waterfall,,bellatrix,1.42,36,-23,13
4585,christmas tree,,cannonwd,1.31,48,-23,25
4584,I am watching you,,82432018,1.59,13,-13,0
4583,The X factor,,koto,1.30,61,-34,27
4582,alien,,82212018,1.64,17,-7,10
4581,Figure of Eight,,squaswin,2.17,8,-1,7
4580,the T,,mumford,1.51,30,-13,17
4579,Galaxy 101,,wambekeim,1.34,28,-18,10
4578,Rule 102,,dannythorne,2.83,5,0,5
4576,Rule 110,,dannythorne,3.50,1,0,1
4575,Tree of Evil,,kkprince,2.36,6,-4,2
4574,make a cycle,,mohammadhm,2.13,10,-2,8
4573,the human,,mumford,1.83,15,-11,4
4572,The second H,,mumford,1.72,17,-9,8
4571,the stairs,,koto,1.63,22,-7,15
4570,the H,,mumford,2.04,18,-6,12
4569,the true tree,,koto,1.30,88,-41,47
4568,victor,,koto,1.33,62,-34,28
4567,I watching U ashley tordoff ,,82432018,1.83,10,-10,0
4566,Fat Burning,,shaggy12,4.50,1,0,1
4565,Fat Burner,,shaggy12,3.67,4,0,4
4564,stars above the stairs,,fultonnt1,1.49,44,-18,26
4563,Windmill,,thvelivan,1.65,20,-6,14
4562,big zzzzzzzzzzzzzzzz,,6zakram,2.00,13,-7,6
4561,Resist The Urge,,axorion,2.81,20,0,20
4560,wonderfull stars,,6zakram,1.69,11,-10,1
4559,Where would you turn?,,mohammadhm,2.37,13,0,13
4558,BIG Stairs,,mohammadhm,2.58,6,-1,5
4557,mhm,,mohammadhm,1.96,15,-2,13
4556,draw and erase like picasa,,mohammadhm,2.07,18,-2,16
4555,bozzle,,vadimcha,1.81,19,-3,16
4554,Square generator,,shaggy12,2.50,2,-1,1
4553,arrow,,cagnew,1.48,19,-9,10
4552,Complicated turn,,marchan,2.50,0,-1,-1
4551,Find Minimum,,qinn,3.17,3,-1,2
4550,Find Maximum,,qinn,3.00,4,-1,3
4549,Maze (Hard),,vorujack,3.05,13,0,13
4548,Maze (Medium),,vorujack,2.18,8,-2,6
4547,Mase (easy),,vorujack,1.83,12,-4,8
4546,Sorting VI,,qinn,4.80,4,0,4
4545,Turn on red,,marchan,3.25,1,-1,0
4544,Fibonacci Subtraction,,axorion,2.91,7,0,7
4543,HalfLife,,almazimberoff1,1.49,20,-14,6
4542,Linked squres II,,marchan,2.89,4,0,4
4541,Linked squares,,marchan,3.00,7,0,7
4540,Power lifting,,mohammadhm,1.90,24,-5,19
4539,Windows,,mohammadhm,1.87,19,-6,13
4538,HMHB,,mohammadhm,1.31,44,-15,29
4537,Can You Find the way,,mohammadhm,1.50,26,-10,16
4536,Turn And double Turn,,mohammadhm,1.44,22,-8,14
4535,Haha Nie zu schaffen,,christopher456,1.65,11,-5,6
4534,Mal schaun,,christopher456,1.38,16,-15,1
4533,Green and Red,,potter2003,1.56,16,-13,3
4532,Bullseye!,,potter2003,1.41,72,-34,38
4531,a,,wiwagi,2.30,3,-4,-1
4530,Round trip II,,marchan,2.36,4,0,4
4529,Round trip,,marchan,2.18,14,0,14
4527,Painting an Aztec Pyramid,,benjaminrr,2.19,23,0,23
4526,Shuttle Or Painter???,,mohammadhm,1.66,34,-4,30
4525,Aztec Pyramid,,benjaminrr,2.42,17,0,17
4524,Blue turner,,mohammadhm,2.33,8,-2,6
4523,1 or 2 ,,mohammadhm,1.58,18,-10,8
4522,What IS this ?,,nanaki404,2.07,7,-5,2
4521,Maze2,,mohammadhm,1.34,43,-16,27
4520,$$$$$$$$,,mohammadhm,1.31,66,-19,47
4519,Triangles,,shaggy12,3.15,12,0,12
4518,simple Stack,,vorujack,2.06,20,-5,15
4517,dalton,,amirabbas,1.29,35,-20,15
4516,Believe you're a knight,,jojoshow,2.19,11,-1,10
4514,Magic Flag,,mohammadhm,1.47,50,-19,31
4513,Magic Maze,,mohammadhm,1.34,49,-22,27
4512,nothing to think,,vorujack,1.38,24,-12,12
4511,Chessboard Challenge,,benoke98,1.72,13,-10,3
4510,Recursion,,benoke98,1.39,35,-18,17
4509,Just One Less Level!,,queencn,1.34,51,-19,32
4508,Tri-states remake,,leo3065,4.00,1,-1,0
4507,Rooms of Turmite,,leo3065,3.00,2,-2,0
4506,Tri-states,,leo3065,2.07,7,-4,3
4505,Ant of Langton,,leo3065,2.62,6,-1,5
4504,Erase And Win,,mohammadhm,1.94,17,-5,12
4503,Pot Metal,,axorion,2.40,2,-1,1
4501,Rashid Mohammadi,,mohammadhm,1.42,29,-16,13
4500,Gopher,,peter,1.33,84,-24,60
4499,stairs,,peter,1.52,31,-11,20
4496,Stripes,,jojoshow,3.07,10,-2,8
4495,que to que,,mohammadhm,1.88,20,-3,17
4494,Think about it,,coxjcj,1.31,51,-22,29
4493,impossable ?,,jojo2979,1.47,31,-15,16
4490,minecarft call123,,call123,1.31,96,-60,36
4489,THE BOX,,deanboy90,1.30,264,-96,168
4487,easy or hard,,mohammadhm,1.46,27,-13,14
4485,Oupss,,sotlylaisse,1.44,40,-7,33
4484,Razzia,,sotlylaisse,2.32,13,-1,12
4480,Random ?,,jojoshow,2.27,8,-1,7
4478,Turn In,,leo3065,1.64,21,-7,14
4477,Happy Indiana Face,,domingoter,1.55,27,-13,14
4476,Dancing Robot,,hempjuice,1.33,61,-15,46
4475,Stack tartare,,jojoshow,2.71,8,-2,6
4474,Fluffy grid of despair,,zero,2.25,28,-2,26
4473,Seven bridges of Koenigsberg,,marchan,2.43,4,-3,1
4471,p,,2016729,1.63,33,-18,15
4470,Frogy,,deanboy90,1.71,15,-9,6
4469,O_o,,zero,2.52,21,0,21
4468,Green Stars,,jojoshow,2.79,16,0,16
4467,M!*CU$,,pooppo67,2.10,3,-3,0
4466,Pizza Delivery N,,shaggy12,2.75,2,0,2
4464,My First Level! :D,,malmalgaming,1.71,28,-11,17
4462,afdfds,,bjorni2,2.04,17,-4,13
4461,basic,,kobel169,2.11,8,-5,3
4460,Locked Box,,minotaur,1.90,8,-5,3
4457,Sneaky spiral,,zero,1.97,29,-1,28
4455,My first try,,jojoshow,2.85,13,0,13
4454,The Red Swap,,sergwind,1.69,24,-6,18
4453,Sparkler,,marchan,2.78,5,0,5
4452,blue quads,,alsawesome,1.82,11,-6,5
4451,Line,,zero,1.54,28,-12,16
4450,Square,,zero,1.34,42,-24,18
4449,Stairs,,zero,1.97,25,-5,20
4448,Apple tree,,zero,2.38,2,-3,-1
4447,Hi,,zero,1.88,12,-8,4
4446,Roller coaster,,marchan,2.71,2,-1,1
4445,Binary Multiplication,,edsaw,5.00,1,0,1
4444,Binary Multiplication,,edsaw,3.25,2,0,2
4443,Binary Multiplication,,edsaw,3.25,2,0,2
4442,Pizza Delivery,,shaggy12,3.20,3,0,3
4441,Stareater,,holger,2.54,7,-3,4
4440,Pizza Delivery,,shaggy12,3.10,10,0,10
4439,1 2 3 4 Recursion 2,,nerdy,2.82,7,-2,5
4438,EASY,,arjun1808,1.39,87,-25,62
4437,Sigma(i) v.0.0,,shaggy12,3.25,11,0,11
4436,red,,wiwagi,5.00,0,-1,-1
4435,A Dark Hallway,,d3v1l,1.39,37,-7,30
4434,Question Mark,,gryffindor04,1.30,54,-9,45
4433,Pokeball,,shinxlover,1.64,11,-7,4
4432,Poseidon's Trident,,gryffindor04,1.86,7,-9,-2
4431,Stairway to Heaven,,d3v1l,1.79,26,-6,20
4430,Sigma(i),,shaggy12,3.80,2,0,2
4429,Only right turns,,foerno,4.33,0,-1,-1
4428,Digital Root 3 - not (mod 9),,cowans,2.75,1,0,1
4427,Filtering IV,,shaggy12,3.40,4,0,4
4426,Knot III,,shaggy12,3.00,1,0,1
4425,Pathmaking,,dvorjakque,3.25,3,0,3
4424,Life without Spring,,smylic,3.00,2,0,2
4423,The Spring of Life,,shaggy12,3.00,7,0,7
4421,Make Your Own Spring,,smylic,3.00,2,0,2
4420,Jostle ,,axorion,3.10,5,-1,4
4419,Turning point,,marchan,2.80,1,-3,-2
4418,Sum of Geometric Sequence,,smylic,3.67,3,0,3
4417,iuff,,escaazul,1.50,24,-12,12
4416,Ruffle Shuffle Permutation,,shaggy12,3.00,1,0,1
4415,Same Same,,edsaw,3.50,4,-1,3
4414,One Another One,,edsaw,3.67,5,-1,4
4413,Divide,,edsaw,4.00,3,0,3
4412,Multiply 2,,edsaw,4.00,2,0,2
4411,The Great Barrier Reef,,shaggy12,3.00,4,0,4
4410,"Pre-Turns, Composition",,dannythorne,3.43,1,-1,0
4409,"Pre-Turns, Part 2",,dannythorne,2.24,15,-2,13
4408,"Pre-Turns, Part 1",,dannythorne,2.20,8,-3,5
4406,smileyz,,killer49,1.32,91,-58,33
4404,Find the Route 2,,smylic,3.80,2,-2,0
4403,Collatz,,dannythorne,2.63,2,-1,1
4402,Joker 2,,shaggy12,3.17,4,0,4
4401,Joker,,shaggy12,3.29,5,0,5
4400,Sokoban,,dannythorne,2.55,31,0,31
4399,move,,rohithc,1.48,46,-18,28
4398,run around,,rohithc,1.59,11,-10,1
4397,Arbor II,,benjaminrr,2.75,3,0,3
4396,Arbor,,benjaminrr,3.09,6,0,6
4395,Josephus problem 2,,smylic,4.00,3,0,3
4394,Tale of Two Tricks,,dannythorne,3.57,3,-1,2
4393,Mosaic,,marchan,3.25,1,-1,0
4392,Josephus problem,,smylic,3.17,5,0,5
4391,super easy,,arjun1808,1.32,106,-42,64
4390,islution,,toodguy,2.11,13,-9,4
4389,wi-red,,toodguy,1.85,22,-10,12
4388,Mean puzzle,,meme2,1.33,47,-25,22
4385,g,,toodguy,1.39,34,-16,18
4384,Its not that hard,,oldmanwilikers,1.76,18,-11,7
4383,DNA with three mutations,,smylic,2.33,15,-2,13
4382,I know this is magic,,smylic,2.62,8,-4,4
4381,Square pie,,smylic,2.67,6,-3,3
4379,Paint a Checkerboard,,dannythorne,2.50,2,-1,1
4378,Meta II,,dannythorne,2.67,2,-2,0
4377,Za spinner,,toodguy,2.56,11,-1,10
4375,"Lively Fun, friends",,jjds,1.45,21,-12,9
4374,Sunset,,dannythorne,2.25,2,-3,-1
4373,"Hack for ""DNA with Mutation""",,dannythorne,2.33,9,0,9
4372,DNA with Two Mutations,,dannythorne,2.80,9,0,9
4371,DNA with Mutation,,dannythorne,2.60,7,0,7
4370,Salt and Pepper,,shaggy12,2.75,1,-2,-1
4369,Platform,,000gjf,2.73,6,0,6
4368,Treasure Hunt In The Dungeon 2,,cowans,3.14,2,-2,0
4366,Meta,,dannythorne,3.20,6,-2,4
4365,die,,arjun1808,1.78,13,-7,6
4364,Exam,,shaggy12,2.67,0,-2,-2
4363,Indangered Snake,,gm101,2.50,3,-3,0
4362,eggs,,arjun1808,1.54,18,-17,1
4361,poptropica,,arjun1808,1.32,27,-25,2
4360,s,,escaazul,1.59,19,-10,9
4359,a,,escaazul,1.97,27,-2,25
4358,this was made randomly,,wiwagi,5.00,0,-1,-1
4357,Tutorial part 5,,marchan,2.54,9,-1,8
4356,Flying saucer,,marchan,3.00,4,-1,3
4355,F,,shaggy12,4.00,5,0,5
4353,I want green!!!!!!,,wiwagi,1.53,22,-5,17
4352,Space Base,,cowans,2.64,7,0,7
4351,Insert Clever Title Here,,gm101,2.24,11,-1,10
4350,Lissajous 2,,axorion,2.33,0,0,0
4349,Lissajous,,axorion,2.20,0,0,0
4348,Leaf Spring,,axorion,2.60,2,0,2
4347,Not That Easy Green Alone,,cowans,3.67,0,-1,-1
4346,qb,,escaazul,1.81,13,-8,5
4345,"Easy, but looks kinda cool.",,gm101,1.46,27,-17,10
4343,funny recursion,,k69evil,2.50,8,-4,4
4342,for beloved,,k69evil,2.22,10,-3,7
4341,Next time on RoboZZle,,shaggy12,2.63,4,0,4
4340,turn around hardcore,,kunwoo0927,3.33,1,-1,0
4338,loveletter for kunwoo,,yclee2001,1.93,15,-10,5
4337,Cross!,,kunwoo0927,2.00,13,-3,10
4336,Non-equidistant Perspective,,cowans,3.00,5,0,5
4335,Not That Easy Red Alone,,cowans,3.20,1,-2,-1
4334,CHANGE THE BOARD!(1),,yclee2001,2.27,11,-2,9
4333,"""Off-By-One"" Error 3",,theme,2.69,13,0,13
4332,Korea,,yclee2001,1.50,21,-9,12
4331,"""Off-By-One"" Error 2",,theme,2.38,11,-1,10
4330,Gun Without A Trigger,,nitron36000,1.38,52,-14,38
4329,Previously on RoboZZle,,shaggy12,2.67,1,0,1
4327,"""Off-By-One"" Error",,theme,2.42,7,-1,6
4326,Interleave,,axorion,2.88,5,0,5
4325,The X Files II,,shaggy12,3.25,3,0,3
4324,The X Files,,shaggy12,3.00,4,0,4
4323,Elementary,,axorion,3.22,27,0,27
4322,Pictograph,,cowans,2.88,5,0,5
4321,3000,,cowans,3.50,1,-1,0
4320,Thing Spring,,axorion,3.00,5,0,5
4319,Pooping and Barfing Shadow,,mickeyross,1.42,35,-28,7
4318,Blue++,,shaggy12,2.62,22,0,22
4317,Spring Thing,,axorion,3.40,4,0,4
4316,Blood Circulation,,shaggy12,3.33,8,0,8
4315,Circumnavigation,,axorion,2.80,4,0,4
4314,Not enough commands,,2070697,1.36,11,-10,1
4312,Tee hee,,2070697,1.45,12,-10,2
4311,Gloomy Blue,,marchan,3.00,2,-2,0
4309,",",,e43ltlarbiter,2.00,8,-7,1
4308,Roception,,ydfwag,1.53,21,-10,11
4307,stay happy,,lowerydr,1.70,7,-10,-3
4306,air plane,,lowerydr,1.58,17,-14,3
4304,BHS,,codycork,1.32,81,-28,53
4303,Abduction,,codycork,1.57,13,-12,1
4302,Easyness,,fallenwest,1.31,101,-48,53
4301,Floating Eye Of Death,,aquabat03,1.90,17,-13,4
4299,Elora,,mtalbott,1.33,65,-23,42
4298,Luv <3,,emilyrham2,1.82,24,-4,20
4296,Rep-Tile,,cowans,2.86,1,-2,-1
4295,Rabbit Wire,,axorion,3.67,3,0,3
4292,The Inside Square = c*c,,cowans,2.55,9,0,9
4291,Accumulation,,cowans,3.08,12,0,12
4290,Tree backwards,,shaggy12,2.67,4,-1,3
4289,+,,denisb,2.17,25,-1,24
4288,Simple Puzzle,,paulreeves,1.32,41,-25,16
4287,Get back! (unlimited?),,denisb,2.64,5,-3,2
4286,Get back unlimited (short),,denisb,1.94,21,-6,15
4285,Get back!,,denisb,2.14,14,-5,9
4284,DAFUQ??,,garrettmci,2.20,16,-6,10
4283,Stack Conditional Paint needed ?,,denisb,2.83,6,-1,5
4282,Support,,shaggy12,2.57,11,0,11
4281,(simple) Roma,,denisb,1.58,26,-5,21
4280,kiko87654321,,kaloyan,1.81,11,-8,3
4279,Roma,,denisb,2.44,9,0,9
4278,Multiply,,shaggy12,3.00,3,0,3
4277,CREEPAH,,garrettmci,1.70,21,-8,13
4276,Balanced (or greater),,denisb,2.55,9,-1,8
4275,All different (3-Permut),,denisb,2.63,2,-1,1
4274,Something Else,,axorion,3.83,2,-3,-1
4273,something,,icecream,1.83,16,-4,12
4272,Which Is Shorter?,,cowans,3.20,4,0,4
4271,If-then-else 2,,shaggy12,3.00,3,-2,1
4270,Note the corners,,angrevol,2.83,4,-2,2
4269,Go Ahead,,1234567,1.79,17,-8,9
4268,Figure-8 2,,nitron36000,1.41,40,-12,28
4267,The Sieve Of Eratosthenes,,cowans,3.20,1,-1,0
4266,Rover Head,,nitron36000,1.86,19,-4,15
4265,Return,,axorion,3.60,3,0,3
4264,Colorful Squares,,nitron36000,1.50,50,-17,33
4263,Figure 8,,nitron36000,1.87,17,-5,12
4262,Yo-yo,,nitron36000,1.48,83,-15,68
4261,If-then-else,,shaggy12,2.20,14,0,14
4260,Different (or 2-permutation),,denisb,3.00,5,0,5
4259,Going To And Fro 2,,edsaw,3.00,1,0,1
4258,Going To And Fro,,cowans,3.00,2,0,2
4253,Sp\red{i}ral,,denisb,3.00,7,0,7
4250,Fading Whirl,,denisb,2.93,14,0,14
4249,Ownknown,,icecream,1.67,29,-9,20
4247,Functional Fulfillment 2,,axorion,2.43,5,0,5
4244,Small Spiral,,denisb,2.95,20,0,20
4243,"Perhaps, One Way",,cowans,3.10,7,0,7
4242,small pyramid with big step,,denisb,2.57,19,0,19
4241,Selection,,nathanstill,1.59,13,-8,5
4239,Pathfinding,,nathanstill,1.82,12,-11,1
4238,Riddle,,ahmedelbashary,2.00,14,-5,9
4236,Bouncing off boxes,,nathanstill,2.00,15,-8,7
4235,Turn 77,,nathanstill,1.58,17,-9,8
4234,Prime numbers,,mikaelmayer,1.73,12,-11,1
4233,design puzzle,,denisb,1.95,16,0,16
4232,Increasing Distance,,cowans,3.50,3,0,3
4231,Citadel,,denisb,3.00,0,0,0
4230,Puzzler 77,,nathanstill,2.29,9,-4,5
4229,Three Notches,,axorion,3.29,4,0,4
4228,Remainders,,axorion,3.21,12,0,12
4227,Starlinator,,denisb,3.00,1,-1,0
4226,Remainder,,cowans,3.42,17,-1,16
4224,Any Way You Want It,,cowans,3.14,5,0,5
4223,3 6 9 12,,denisb,2.12,9,-2,7
4222,Sorting V,,qinn,4.75,4,0,4
4221,Chessmen move,,marchan,2.67,4,-1,3
4220,Two tiles missing,,denisb,1.79,11,-5,6
4219,Not enough?,,denisb,2.06,11,-2,9
4218,Draw lots,,marchan,2.83,7,0,7
4217,Exp 2 4 8 16 32 (with **) ,,denisb,2.43,5,0,5
4216,Logic Gates - Star is True,,cowans,3.40,1,-2,-1
4215,RectRound,,denisb,3.33,4,-1,3
4213,Tournez maneges ...,,denisb,3.67,0,-1,-1
4212,Histgram of Squares,,cowans,2.75,6,0,6
4211,Log 2 3 4 5 5 7 8 9 11,,denisb,2.78,5,0,5
4210,Second and third powers,,shaggy12,2.75,6,0,6
4209,logarithmic spiral,,denisb,2.78,6,-1,5
4208,Fibonacci Tiling,,cowans,2.50,4,-1,3
4207,Padovan Sequence,,cowans,2.67,3,0,3
4206,Third power,,shaggy12,1.89,6,-3,3
4205,Second power,,shaggy12,2.86,3,0,3
4204,Nickel & Dime,,axorion,2.67,3,0,3
4203,Napier,,denisb,2.88,2,-3,-1
4201,Mostly Sixes,,axorion,2.69,11,0,11
4200,small logarithmic pyramid,,denisb,2.31,26,0,26
4199,Napier,,denisb,4.00,3,0,3
4198,Which is Longer?,,cowans,2.80,4,0,4
4197,Multiplication of Signs,,cowans,3.33,0,0,0
4196,Napier,,denisb,3.00,1,0,1
4195,Napier,,denisb,2.67,5,-2,3
4193,Holmes vs Poirot,,shaggy12,3.14,3,-2,1
4192,Treasure Hunt in the Dungeon,,cowans,2.50,3,-2,1
4191,ooops,,parenyok,1.33,106,-50,56
4190,Tree,,denisb,2.23,19,-2,17
4189,Tree,,denisb,2.39,13,-3,10
4188,Double pinwheel,,marchan,2.44,8,-3,5
4185,Seeing stars,,i4ever,2.27,10,-2,8
4184,Digital Root - 2,,cowans,3.00,4,0,4
4183,Decimal Digit Sum,,edsaw,3.00,5,0,5
4182,Digital root,,cowans,3.00,2,0,2
4181,Important Factors,,edsaw,4.80,4,0,4
4180,Sweethearts' Puzzle,,kirstyxytsrik,1.48,74,-16,58
4179,Super Easy,,kirstyxytsrik,1.54,66,-19,47
4178,Triple X Factor,,edsaw,4.50,0,0,0
4177,As usual ? - 3,,cowans,2.50,8,-1,7
4176,The X Factor,,edsaw,4.40,5,0,5
4175,Divisor and quotient,,cowans,3.40,4,0,4
4174,Sequential square numbers,,cowans,2.86,6,0,6
4171,kakvo,,milusheva,1.38,14,-15,-1
4169,Earthquake,,shaggy12,2.50,6,-1,5
4168,More easy ladder,,cowans,2.60,1,-1,0
4167,Easy ladder,,cowans,2.44,13,-1,12
4166,Ladder sideways,,cowans,2.90,6,0,6
4165,Outlined in Red,,smileyfaces88,2.17,7,-8,-1
4160,Oct-path,,cowans,2.71,3,-1,2
4159,123,,kokos,1.73,34,-5,29
4158,Counting Branches,,shaggy12,4.75,3,0,3
4157,Lisa Bonet ate no Basil,,edsaw,4.25,3,0,3
4156,Half Kite,,kokos,1.92,15,-4,11
4155,Turn `after red` 2,,shaggy12,4.09,10,0,10
4149,As usual ? - 2,,cowans,3.20,3,-2,1
4147,As usual ?,,cowans,2.28,12,-2,10
4146,Hypno,,coldmind,1.85,28,-12,16
4145,Need.. one.. more..,,coldmind,1.86,23,-3,20
4144,kokos1,,kokos,1.32,74,-24,50
4143,Sequential factorials,,cowans,3.20,1,-2,-1
4140,Left on blue,,shaggy12,2.57,4,-2,2
4139,Snake,,zzh8829,2.13,12,-2,10
4138,Unusual stairs,,shaggy12,3.00,8,0,8
4137,Strapped chain,,cowans,3.50,1,0,1
4136,tree 1 modified 2 ,,kirarpit,3.64,9,-1,8
4135,Summation,,cowans,4.00,1,-1,0
4134,Subtraction,,cowans,4.00,0,-1,-1
4133,Inchworm,,snuke,3.25,2,-1,1
4132,Meme ,,axorion,2.67,4,-1,3
4131,Minkowski,,snuke,2.50,9,-1,8
4130,Walls and cycle,,snuke,3.67,2,-3,-1
4129,Square!?,,shaggy12,2.00,8,-6,2
4128,Spiral leaf,,snuke,2.43,2,-3,-1
4127,Final Rect??,,snuke,2.00,13,-2,11
4126,Xbox 2,,smylic,3.50,3,0,3
4125,Rect??,,snuke,2.20,19,-1,18
4124,Rect?!,,snuke,2.24,10,-1,9
4123,Rect!!,,snuke,2.14,18,-2,16
4122,Rect!?,,snuke,2.85,32,-2,30
4121,Xbox,,snuke,3.09,8,0,8
4120,Exacerbated Spiral,,axorion,3.50,8,0,8
4119,Mitigated Spiral ,,axorion,3.09,12,0,12
4118,Spirals,,shaggy12,3.20,2,-1,1
4117,Four wells 1.1,,marchan,2.50,2,-4,-2
4116,Holes,,redant,1.81,22,-4,18
4115,Four wells,,marchan,2.44,7,-3,4
4114,Funk Quad,,axorion,2.75,6,0,6
4113,simple,,1111,1.39,46,-26,20
4111,Navigational Necessities 1.1,,axorion,3.00,6,-1,5
4110,Navigational Necessities,,axorion,3.29,5,-1,4
4109,Echo,,shaggy12,2.50,3,-1,2
4108,Hexed,,axorion,2.86,5,-1,4
4102,TACO (Mexican food),,kakuoh,2.57,2,-4,-2
4101,Really Easy,,mochi,1.35,52,-29,23
4100,Leaves 0,,shaggy12,3.33,3,0,3
4099,Leaves,,shaggy12,4.00,3,0,3
4098,Suspend a bridge,,kakuoh,2.67,1,-3,-2
4097,Magic square,,kakuoh,2.00,5,-6,-1
4096,Swastika,,kakuoh,2.07,21,-1,20
4095,Maze1,,simsim314,2.23,17,-3,14
4094,Surrounded,,talkol,2.19,11,-4,7
4093,Fractals,,talkol,2.12,15,-1,14
4092,Night Sky,,talkol,2.00,18,-2,16
4091,Photosynthesis,,talkol,2.56,14,0,14
4090,Don't go Left,,fastflask,2.15,9,-2,7
4089,Red stars 2,,arry,1.78,28,-4,24
4088,Red stars,,arry,1.35,52,-24,28
4086,Claw crane - L catcher,,kakuoh,3.20,2,-3,-1
4085,Offset Stack,,axorion,2.60,3,0,3
4084,Scale Factors,,axorion,2.86,7,0,7
4083,The great turbine,,talkol,2.17,14,-3,11
4080,Mind the gap,,talkol,1.34,40,-19,21
4079,Question 2013,,kakuoh,4.00,1,-2,-1
4078,Functional Fulfillment,,axorion,3.00,7,0,7
4077,dizzy,,chanyaaa,2.21,14,-6,8
4076,Blurry snake,,shaggy12,3.00,0,0,0
4075,"Blue, Green and Red",,imzeer0,1.35,49,-21,28
4074,2013,,shaggy12,2.27,8,-2,6
4073,Simmetry - Flower,,shaggy12,2.40,2,0,2
4072,Headache,,pokelvis,1.55,22,-19,3
4071,Keep off the grass 2,,kakuoh,2.44,8,-4,4
4070,Keep off the grass,,kakuoh,2.25,9,-4,5
4069,Root 2 (or route 2),,kakuoh,2.31,8,-5,3
4068,Yo Ho Ho Hum,,axorion,2.55,8,0,8
4067,The answer is Blue in the wind,,kakuoh,2.57,2,-3,-1
4066,Green Signals 3 (Perverseness),,kakuoh,3.40,3,-2,1
4064,Christmas Tree 2,,hsw230,1.31,65,-17,48
4063,wut?,,edsups,2.00,17,-5,12
4062,Christmas Tree,,hsw230,1.48,51,-23,28
4061,Christmas,,tinkz,1.34,61,-32,29
4060,Green Signals 2 (Improved),,kakuoh,3.13,7,-1,6
4059,easy,,matuke,1.49,41,-16,25
4058,Green Signals 2,,kakuoh,2.80,2,-2,0
4057,Differencies,,shaggy12,3.20,1,-1,0
4056,Green Signals,,kakuoh,2.91,6,-2,4
4055,Run 1,,pagal196,1.37,64,-36,28
4054,The Whip,,kakuoh,3.22,5,-3,2
4053,Red Blossoms,,kakuoh,2.53,18,0,18
4052,Mistakes,,shaggy12,2.67,4,-1,3
4051,stacking,,pagal196,1.85,12,-10,2
4050,Aspect Ratio,,axorion,2.60,6,0,6
4048,U Turns,,sunny_rr,2.20,11,-2,9
4046,the three functions,,euan1505,2.18,9,-3,6
4045,Do not turn,,shaggy12,3.50,2,-3,-1
4044,A turn of events - Revised,,masterluk,3.71,4,-1,3
4042,A turn of events,,masterluk,2.89,4,-1,3
4041,Needle,,shaggy12,2.50,3,0,3
4040,Borrowed Stack 2,,shaggy12,3.20,2,-1,1
4039,Borrowed Stack,,axorion,2.63,28,0,28
4038,DNA,,axorion,3.75,1,-2,-1
4037,free easy,,2070728,1.45,46,-15,31
4035,Spring 10,,shaggy12,2.63,4,0,4
4034,Spring 10,,shaggy12,3.00,7,0,7
4030,jumper,,andressomer,1.31,8,-10,-2
4029,crazy puzzle 2,,andressomer,1.51,37,-14,23
4028,escape the box,,2070728,1.32,88,-21,67
4027,revenge,,2070728,1.34,86,-19,67
4024,crazy puzzle,,andressomer,2.15,12,-8,4
4023,box + hole,,andressomer,1.90,14,-10,4
4021,HARDNESS,,2070728,1.66,19,-5,14
4015,face,,andressomer,1.65,21,-8,13
4014,blue spiral,,andressomer,2.10,13,-8,5
4013,Good night,,shaggy12,3.33,2,0,2
4011,tree 1 modified,,kirarpit,1.35,68,-17,51
4010,Tim's Puzzle #4,,timthree,2.00,3,-5,-2
4009,kite,,abhishekgargg,2.21,14,0,14
4008,"Left on even, right on odd fixed",,shaggy12,2.27,6,0,6
4007,"Left on even, right on odd",,shaggy12,1.92,12,-4,8
4006,An Ant's Pitfall,,samueltangz,2.88,5,-4,1
4005,"So close, yet so far away",,shaggy12,3.09,17,-1,16
4004,Election Day,,axorion,3.20,5,0,5
4003,Tim's Puzzle #3,,timthree,1.84,25,-6,19
4002,Tim's Puzzle #2,,timthree,1.93,29,-2,27
4001,Tim's Puzzle #1,,timthree,1.65,33,-1,32
4000,Rollin on a River,,philly,2.19,8,-7,1
3998,Eyes,,philly,2.10,22,-3,19
3997,Tricky Red,,philly,1.77,32,-6,26
3995,around and around,,philly,1.34,45,-17,28
3993,Congruency,,philly,1.92,15,-3,12
3992,The Robot,,philly,1.78,8,-7,1
3991,The Red Cross,,philly,1.45,29,-15,14
3990,Diagonal Confusion,,iglenini,2.25,11,-2,9
3989,Diagonal Difficulty,,iglenini,2.00,9,-1,8
3988,Tablecloth,,iglenini,1.88,22,-7,15
3986,Red tree,,mike239x,2.15,16,-3,13
3985,Green middle,,mike239x,2.72,21,0,21
3984,Cookie,,snuke,3.40,3,0,3
3983,Langton's Ant,,mike239x,2.22,12,-5,7
3982,Dragon curve,,snuke,3.33,1,-2,-1
3981,Compass,,sticky,2.32,17,0,17
3980,A Square Deal,,axorion,2.86,2,-1,1
3979,Twice called recursion,,snuke,3.29,5,-1,4
3978,Fibonacci squares,,snuke,4.00,1,0,1
3977,Fill square 2,,snuke,2.56,5,-2,3
3976,Fill square,,snuke,2.82,6,-2,4
3975,Choose Your Ratio,,kynake,2.38,6,0,6
3974,harderish,,ehxx,1.34,32,-21,11
3973,go,,ehxx,1.31,48,-17,31
3972,robot,,robotemily,1.35,44,-19,25
3971,Marks,,shaggy12,1.93,21,-4,17
3970,Bridge,,skinnymage,1.49,33,-8,25
3969,Round Trip,,skinnymage,1.49,52,-13,39
3968,DERP,,ehxx,1.91,9,-10,-1
3966,Spin and Win,,strempo,2.13,12,-5,7
3964,Checkers,,hannah123,1.47,21,-12,9
3963,Jogging,,shaggy12,2.88,4,-1,3
3962,cool storie bro,,puzzlemaster,1.30,139,-61,78
3961,The Box,,darkspy155,1.31,340,-107,233
3959,Level 4,,mathhouse,1.33,102,-34,68
3958,Level 3,,mathhouse,1.97,19,-7,12
3957,Level 2,,mathhouse,1.47,34,-14,20
3956,Level 1,,mathhouse,1.49,33,-13,20
3955,test,,mathhouse,1.36,57,-34,23
3954,good luck,,702098003,1.40,34,-32,2
3952,Fibonacci Numbers 2.2,,smylic,5.00,1,0,1
3950,Fibonacci Numbers 1.2,,smylic,5.00,2,0,2
3948,Fibonacci Numbers 1.1,,smylic,3.67,0,0,0
3947,Smiley Face :),,839730,1.34,57,-47,10
3945,easy2,,sammy_ward15,1.35,58,-34,24
3944,Yo no miento...Papito,,juanpablo,5.00,0,-1,-1
3943,Turn right on stars IV,,edsaw,4.25,4,0,4
3942,The X Of Doom,,utugateg,1.34,68,-40,28
3941,"End of the world, part 2",,shaggy12,2.83,5,-1,4
3940,Fibonacci Numbers 2,,smylic,3.67,1,0,1
3939,Five Times,,kraker,3.13,7,0,7
3938,For Beginers,,arenam,1.56,62,-15,47
3937,Robozzle Pour Un Autre Jour,,axorion,2.40,1,0,1
3936,One Mouse,,arenam,2.46,7,-2,5
3934,??????,,shaggy12,3.20,2,-1,1
3933,Hailstone sequence 2,,smylic,4.25,4,0,4
3932,Hailstone sequence,,smylic,4.20,3,0,3
3931,"End of the world, part 1",,shaggy12,2.75,0,-2,-2
3930,Twice,,kraker,3.00,2,0,2
3929,Humdrum Conundrum,,axorion,4.00,1,0,1
3928,Robozzle Du Jour 1.1,,axorion,2.56,5,0,5
3927,Robozzle Du Jour,,axorion,2.77,8,-2,6
3926,Impediment,,axorion,2.67,3,0,3
3925,Exhausted Novelty,,axorion,3.00,10,0,10
3924,666,,shaggy12,3.14,5,-1,4
3923,Mountain Chain,,qinn,3.03,38,0,38
3922,Lightning II,,shaggy12,2.80,2,0,2
3921,Lightning,,shaggy12,2.38,8,0,8
3920,Boomerang II,,vitalstatistic,2.33,14,-2,12
3919,3 xor 5,,shaggy12,2.71,3,0,3
3918,3 but not 2 or 5 and 2,,shaggy12,3.20,1,-1,0
3917,Prettyful,,stewes,1.59,25,-11,14
3914,Early Marked Bridges,,qinn,4.25,4,0,4
3913,Person,,stewes,1.74,18,-10,8
3912,5th Avenue,,denisb,2.63,4,-1,3
3911,Fifth (last of five),,denisb,3.50,1,-3,-2
3910,IIIII or I II II (same five ?),,denisb,2.36,9,-1,8
3908,Five by five,,denisb,2.10,14,-2,12
3907,N1K05,,nikoswolf,2.00,11,-5,6
3906,Give me five ;),,denisb,2.07,22,-4,18
3905,Five easy pieces ...,,denisb,1.71,36,-7,29
3904,Mutation,,shaggy12,3.80,5,0,5
3903,Confusion,,tekknoost,4.33,1,-2,-1
3901,Alt.,,denisb,2.00,21,-4,17
3900,easy one,,cagdassalur,2.11,30,-1,29
3899,.,,nikoswolf,2.16,28,-1,27
3898,Dear Sebastian,,cagdassalur,2.04,13,-2,11
3897,Simple,,nikoswolf,1.49,41,-14,27
3896,Blue Lagoon,,shaggy12,2.71,3,-3,0
3895,Repeating Tree 2.1,,azure,4.33,3,0,3
3894,Increasing Squares,,azure,3.25,3,0,3
3892,Green Lane,,shaggy12,2.88,18,0,18
3890,Sharp,,shaggy12,3.17,6,0,6
3888,stairs,,puzzlemaster,1.72,17,-16,1
3887,race me,,luba224,1.36,48,-42,6
3885,maze,,luba224,1.51,31,-20,11
3884,General Quarters,,axorion,4.00,4,-1,3
3883,drifter,,luba224,1.50,13,-13,0
3881,groovey,,puzzlemaster,1.33,48,-33,15
3879,Wave,,denisb,2.11,13,-4,9
3875,Depth Finder,,axorion,3.43,7,0,7
3874,Sectors,,arenam,1.71,18,-14,4
3873,Alt.,,denisb,3.00,16,0,16
3872,Exciting,,arenam,2.35,9,-3,6
3871,Lights Out,,axorion,3.43,7,0,7
3870,Broken Light Switch,,axorion,2.83,3,-2,1
3869,Repeating Tree 3,,azure,4.50,4,0,4
3868,Repeating Tree 2,,azure,4.20,5,0,5
3867,Repeating Tree,,azure,2.94,17,0,17
3866,Light Switch 3,,smylic,4.00,2,0,2
3865,Reg or green Butterfly,,denisb,3.00,2,-1,1
3864,Light Switch,,edsaw,4.50,2,0,2
3863,Light Switch,,qinn,4.00,4,0,4
3862,.ver s'thginK,,denisb,2.18,13,-1,12
3861,Fifths of Fury 3,,shaggy12,3.00,2,0,2
3860,Fifths of Fury 2,,axorion,2.58,10,0,10
3859,Filtering III,,shaggy12,3.75,2,0,2
3858,Filtering II,,shaggy12,3.60,3,-1,2
3857,Filtering I,,shaggy12,3.57,5,0,5
3856,Fifths of Fury,,axorion,3.38,10,0,10
3855,Childish crossing,,denisb,2.43,4,-1,3
3854,LL,,shaggy12,3.00,1,-2,-1
3853,#NAME?,,lezinha,2.00,11,-5,6
3852,Why not another diagonal?,,denisb,2.80,1,-3,-2
3851,Turn `after red`,,shaggy12,2.86,18,0,18
3850,DIY,,shaggy12,2.25,8,-1,7
3849,2000,,dorian_gray,2.19,7,-4,3
3848,Almost diagonal,,denisb,3.75,2,-2,0
3847,Transmigrations,,axorion,2.89,6,0,6
3846,Cavern,,shaggy12,4.00,1,0,1
3845,123210,,shaggy12,3.40,5,0,5
3844,Cube,,spinoz,1.36,47,-38,9
3843,Withou stack (Re:Why stack),,denisb,2.00,6,-1,5
3842,Top Designer (10 000),,denisb,1.41,27,-25,2
3841,"More, less, or equal",,denisb,2.90,5,-1,4
3840,Odd or even,,denisb,2.31,32,0,32
3839,Sequence Spiral III,,qinn,5.00,1,0,1
3838,Why stack (full recursion)?,,denisb,2.50,18,0,18
3837,Whirled Domination,,axorion,3.33,12,0,12
3836,Not for smylic :p (too easy and boring),,denisb,3.50,1,0,1
3835,Full path of stars (for sticky),,denisb,3.00,3,-1,2
3834,Out of nothing,,denisb,3.40,4,0,4
3833,Repaint,,denisb,3.33,4,-1,3
3832,Translate-Repaint,,denisb,3.00,5,0,5
3831,Big pattern (but pattern),,denisb,3.09,11,0,11
3830,Half missing! (the most important part),,denisb,2.90,4,-1,3
3829,Almost same spiral backward?,,denisb,2.64,10,-5,5
3828,Something missing?,,bebe,3.38,7,-1,6
3827,Simple small stacked spiral symmetrized,,denisb,2.62,23,-1,22
3826,4 of a kind,,shaggy12,3.14,5,0,5
3825,Exactly...,,2016mrhnathan,1.30,168,-80,88
3824,In Search of Atlantis 2,,smylic,3.00,0,0,0
3823,Knowledge,,shaggy12,3.00,5,0,5
3822,In Search of Atlantis,,smylic,3.00,0,0,0
3821,Void Expedition,,sticky,2.71,5,0,5
3820,"Left on Green, Right on Red 2",,smylic,3.75,3,0,3
3819,Faraway Star,,smylic,2.92,20,-3,17
3818,Crossroads,,shaggy12,2.69,13,-1,12
3817,8 in a row,,shaggy12,4.33,1,-1,0
3816,green,,carpx,1.56,51,-18,33
3815,Turn right on stars III,,dorian_gray,2.25,21,0,21
3814,wacko's vill down town,,2016mrhluke,1.97,14,-11,3
3813,Wacko's slide and kiddy pool ,,2016mrhluke,1.55,25,-12,13
3812,Ternary,,sticky,3.20,5,0,5
3811,Denatured,,axorion,4.50,1,0,1
3810,S,,ak172,1.43,50,-25,25
3809,My Revenge,,ab172,1.31,420,-202,218
3807,K,,ak172,1.31,186,-88,98
3805,E,,ak172,1.31,111,-46,65
3804,cow 3,,1970067,1.75,16,-15,1
3803,Stairs ,,ev462,1.46,53,-25,28
3802,cow 2,,1970067,1.51,26,-12,14
3801,The maze ,,ev462,1.32,63,-37,26
3800,"Less paint, more fun?",,denisb,3.20,3,-2,1
3799,"More paint, more fun?",,denisb,2.69,10,-3,7
3798,The Problem,,meebie2,1.51,39,-13,26
3797,The Beggining,,meebie2,1.38,49,-21,28
3795,Full (stack),,denisb,2.00,16,-7,9
3794,Sequence Spiral II,,qinn,3.00,1,-1,0
3793,Know Your Rights,,axorion,3.36,5,0,5
3792,A little more fun with painting,,denisb,3.14,4,-2,2
3791,Little fun with painting,,denisb,1.36,77,-14,63
3790,cow,,1970067,1.67,20,-16,4
3788,1111,,2016mrhkarlye,1.70,20,-8,12
3786,cool VI,,2016mrhkylie,1.51,57,-26,31
3785,shoe3,,2016mrhizzy,1.36,76,-40,36
3784,smiley,,2016mrhdavid,1.35,89,-26,63
3783,cool V,,2016mrhkylie,1.61,19,-14,5
3782,shoe2,,2016mrhizzy,1.31,146,-60,86
3781,cool IV,,2016mrhkylie,1.42,61,-29,32
3780,shoe,,2016mrhizzy,1.31,208,-90,118
3779,Full (init),,denisb,3.17,4,-1,3
3778,cool III,,2016mrhkylie,1.42,39,-21,18
3776,cool II,,2016mrhkylie,1.44,31,-18,13
3775,north ridge,,2016mrhnathan,1.37,34,-29,5
3774,Loop da Loop,,2016mrhnathan,1.47,17,-16,1
3773,RED PUZZLE,,2016mrhnathan,1.31,366,-92,274
3772,The End,,meebie2,1.39,56,-35,21
3771,"Outside square: circle ! (yes, indeed)",,denisb,3.00,4,0,4
3770,cool,,2016mrhkylie,1.35,41,-18,23
3769,butterfly,,2016mrhizzy,1.80,18,-7,11
3768,Square,,scathaniel,2.65,21,0,21
3767,Easy,,neglits,1.66,21,-15,6
3766,Inside square: circle,,denisb,2.63,11,-1,10
3764,horse 3.0,,laptchik,1.80,18,-4,14
3763,horse,,laptchik,1.63,30,-7,23
3762,horse,,laptchik,1.75,24,-8,16
3761,Title,,neglits,1.40,47,-14,33
3760,Inside robozzle,,denisb,2.75,3,0,3
3759,Green ladders,,denisb,2.63,3,-2,1
3758,Turn right on stars II,,dorian_gray,3.75,7,0,7
3757,Turn right on stars,,dorian_gray,4.33,1,0,1
3755,INVERTED CREEPAH!!,,meebie2,1.77,13,-9,4
3754,stage impossable,,2016mrhchris,1.56,41,-26,15
3753,9 x 8 = 72,,2016mrhnoah,1.63,24,-14,10
3752,Don't get an F,,henselkp,3.17,18,-6,12
3751,River in the rocks,,shaggy12,2.93,13,0,13
3750,Willow,,shaggy12,4.00,1,-2,-1
3749,Multiple Find III,,shaggy12,3.13,5,0,5
3748,Cube,,denisb,3.00,7,0,7
3747,The funktions!,,hummel,1.49,36,-21,15
3746,chinese house,,2016mrhnoah,1.74,13,-11,2
3745,4 stars,,2016mrhchris,1.30,154,-52,102
3743,Hexagones,,denisb,2.86,4,-1,3
3742,e,,ak172,1.37,48,-32,16
3741,Red ladders,,denisb,2.91,8,0,8
3740,THE PUZZLE,,ok173,1.43,34,-28,6
3739,Twozzle,,angrevol,2.30,16,-2,14
3738,ZZZ,,denisb,2.63,5,-1,4
3737,mj,,2016mrhdavid,1.31,138,-43,95
3735,Assigned,,henselkp,1.55,32,-25,7
3734,Functional Deficiency 2,,axorion,3.50,3,0,3
3733,The big C,,angrevol,1.31,195,-66,129
3732,Reverse way,,angrevol,2.22,16,-1,15
3731,Just go !,,angrevol,2.53,8,-3,5
3730,Neighborhood,,shaggy12,2.80,7,-1,6
3729,Few more squares,,denisb,3.14,4,0,4
3727,Isosceles rectangled triangles,,denisb,2.81,14,0,14
3726,Long Way To Go,,shaggy12,5.00,0,0,0
3725,Stewie Griffen,,ab172,1.31,304,-122,182
3724,Caterpillar,,shaggy12,3.50,2,0,2
3723,Blue ladders,,denisb,2.75,9,0,9
3722,Good Evening,,shaggy12,3.67,2,-1,1
3721,Good Morning,,shaggy12,3.00,2,-1,1
3720,Tower sleeping (in the horizontal),,denisb,3.17,5,0,5
3719,spider man,,2016mrhdavid,1.31,182,-51,131
3717,Big square becomes lace square ,,denisb,3.25,3,0,3
3716,Impossble town,,2016mrhadam,1.81,15,-14,1
3715,Big tree,,joey324,1.33,89,-36,53
3714,New York Around the Globee,,joey324,1.32,126,-26,100
3713,Reverse,,denisb,3.08,11,0,11
3712,DOUBLE CREEPAH!!,,meebie2,1.44,37,-23,14
3711,Palindrome,,denisb,3.00,1,-1,0
3710,Functional Deficiency,,axorion,3.57,7,0,7
3709,Gathering Information 3,,smylic,3.67,2,0,2
3708,Fibonacci Numbers,,smylic,3.75,3,0,3
3707,Sort (permutation),,denisb,3.40,3,0,3
3706,Find All II,,qinn,3.67,2,0,2
3705,Plateau,,axorion,3.21,13,0,13
3704,Find minimum (was easy),,denisb,1.71,26,-6,20
3703,Find All,,qinn,3.33,2,0,2
3702,Multiple find II,,keyon,3.00,4,-1,3
3701,multiple find,,denisb,2.91,8,-1,7
3700,Find first,,denisb,1.96,18,-5,13
3699,Reflection IV,,smylic,3.75,3,0,3
3698,Binary Reflection,,smylic,4.33,4,0,4
3697,MidPoint,,denisb,2.12,41,0,41
3696,Swap,,denisb,3.29,5,0,5
3695,Information Gathering 2,,smylic,4.00,4,0,4
3694,The Whole Cake,,axorion,3.00,4,0,4
3693,A Piece Of Cake,,axorion,3.20,7,0,7
3692,SpiderWeb,,denisb,3.43,4,-1,3
3691,Spider,,denisb,2.43,5,0,5
3689,Recursive,,avalancher,3.21,13,0,13
3687,Maximum,,denisb,3.31,16,0,16
3686,Minimum,,denisb,3.22,20,0,20
3685,Equilibrium,,axorion,3.67,5,0,5
3684,More or Less the Same ? ? ?,,denisb,3.25,7,0,7
3683,"Spiral? No, I want to be a box!",,benjaminrr,2.63,6,0,6
3682,Newton's Third,,axorion,2.93,12,0,12
3681,No limit,,denisb,3.19,15,0,15
3680,Wirl ...,,denisb,2.61,20,0,20
3679,Reflection III,,qinn,3.33,5,-1,4
3678,c,,bf172,1.39,56,-29,27
3677,Von Koch,,denisb,2.63,13,0,13
3675,moderate level,,meebie2,1.48,44,-16,28
3674,T,,denisb,4.00,2,0,2
3673,"Right on Red, Left on Green",,azure,2.83,13,0,13
3672,Levels,,shaggy12,3.50,0,0,0
3671,Hieroglyph,,shaggy12,3.43,6,0,6
3670,Paint vs Stack vs Straight,,denisb,1.91,27,-3,24
3669,Data Spiral Transfer Beta,,qinn,4.25,3,-1,2
3668,No I in Team II,,benjaminrr,2.83,9,0,9
3667,Data Spiral Transfer Alpha,,benjaminrr,3.17,6,0,6
3665,Squared,,denisb,3.00,4,-1,3
3663,Star war,,denisb,2.21,13,-1,12
3661,Crab vs CRAB,,denisb,4.00,1,0,1
3659,BBQ,,cha93w,1.34,83,-47,36
3658,,,ak172,1.46,33,-27,6
3657,jeo blow,,cha93w,1.32,110,-72,38
3656,Little Bo Peep,,df172,1.44,38,-30,8
3655,,,ak172,1.39,75,-33,42
3654,?,,ak172,1.38,23,-27,-4
3652,box,,ak172,1.32,266,-107,159
3649,Way to easy!!,,ev462,1.31,338,-131,207
3648,is easy or is it hard?,,ev462,1.51,41,-17,24
3647,Hollow Tree,,axorion,3.50,2,0,2
3646,"Yyou can aim at the target, ",,denisb,2.67,6,-1,5
3645,One more tree (for the planet),,denisb,2.33,20,-4,16
3643,Polly Wolly Doodle,,axorion,3.50,3,-1,2
3642,"1, 2, Buckle my shoe;",,denisb,2.50,3,-1,2
3641,Title,,denisb,3.29,5,-1,4
3640,which way,,subham,1.39,37,-21,16
3639,The eye of Sauron,,meebie2,1.55,21,-13,8
3638,Checkers,,meebie2,1.43,19,-20,-1
3637,Hypnosis,,denisb,1.96,16,-5,11
3636,C,,denisb,3.25,5,-1,4
3635,Anticipation,,axorion,3.00,9,0,9
3634,Hop-o'-My-Thumb,,denisb,4.00,1,-2,-1
3633,Polly Want Another Cracker?,,benjaminrr,2.82,16,-1,15
3632,Double back,,onqt,2.67,6,0,6
3630,Forest paths,,shaggy12,3.50,0,0,0
3623,Spilled stars 2,,onqt,2.00,1,-2,-1
3622,Spilled stars,,onqt,3.40,2,-4,-2
3620,Too Easy 2,,df172,1.31,222,-82,140
3617,Groove Coverage IV,,shaggy12,3.25,7,0,7
3615,green red,,bf172,1.40,41,-26,15
3613,Too Easy,,df172,1.32,78,-36,42
3612,Twisted Behavior,,skryb,3.40,3,-1,2
3606,Is there any more?,,antonbootsma,2.38,4,-1,3
3597,Swirly Sue's Stack,,avarga,2.56,25,0,25
3596,temporary,,lordkelvin,1.80,7,-6,1
3595,tile graph,,onqt,3.00,2,0,2
3590,Twisted spiral,,shaggy12,3.25,1,-1,0
3589,Playing around,,shaggy12,3.00,3,-1,2
3588,Top Secret,,axorion,4.00,1,0,1
3587,random,,bf172,1.30,148,-64,84
3585,Hansel & Gretel,,denisb,3.17,3,0,3
3584,Snake on grass,,denisb,1.79,28,-10,18
3583,Big Dipper,,onqt,2.40,5,-3,2
3582,fishing hook,,onqt,2.00,26,-2,24
3581,"Snake (hum, was)",,denisb,3.14,4,0,4
3580,A Space Odyssey,,axorion,3.33,4,0,4
3579,Drift,,denisb,4.00,0,0,0
3578,The Broken Corner,,axorion,2.31,19,-2,17
3577,Full-screen,,meebie2,1.45,83,-27,56
3576,FFLFLLFFLLFLLL,,denisb,4.00,2,0,2
3575,A twisted light.,,subham,1.31,283,-81,202
3574,Trivia,,smylic,4.00,2,-1,1
3573,b,,bebe,3.20,2,-1,1
3572,Encryption 2,,axorion,4.00,1,0,1
3570,My First Level (Fail),,meebie2,1.50,109,-32,77
3569,Canvas,,denisb,2.80,1,-2,-1
3568,Pyramid,,denisb,3.00,2,0,2
3566,Manhattan,,denisb,2.11,10,-5,5
3565,My puzzle,,andres,1.53,34,-9,25
3564,a,,denisb,4.00,1,0,1
3563,Fruit of the Vine,,axorion,3.60,5,0,5
3562,Mask,,denisb,2.42,10,-3,7
3561,red herring,,delisoccer,2.80,5,-2,3
3560,Fox,,denisb,3.17,3,-2,1
3559,Glasses,,denisb,3.12,16,0,16
3558,Scratch,,denisb,3.00,10,-1,9
3557,Rule 30,,avarga,2.29,7,-1,6
3556,Dead ends,,denisb,2.77,10,-1,9
3555,Dual,,denisb,2.86,12,0,12
3554,Humanely 'quite' easy,,denisb,2.64,5,-1,4
3553,Simple Puzzle 3: Star Maze,,codycat99,1.30,227,-79,148
3552,Golden1,,goldtigress,1.63,27,-6,21
3550,Way too easy,,denisb,1.29,144,-31,113
3548,DNA,,denisb,1.78,25,-15,10
3547,"In, not out, but In In ?",,denisb,3.83,5,0,5
3546,"In, not out, but In In ...",,denisb,3.22,7,0,7
3545,Rings,,axorion,3.57,4,-1,3
3544,Greed island,,greedy,1.56,69,-18,51
3543,Clueless,,axorion,3.40,3,-2,1
3542,Square,,mohre,1.63,31,-8,23
3541,Infinite simple loop,,denisb,3.20,4,-1,3
3540,Infinite loop,,denisb,3.50,3,0,3
3539,"Crowded (trefoils, shamrocks, clovers)",,denisb,3.08,11,0,11
3538,Now ,,juanpablo,?,0,0,0
3536,Encryption,,axorion,3.33,2,0,2
3535,Shamrock ?,,denisb,3.00,16,0,16
3534,100,,avarga,2.20,9,-3,6
3533,Pascal,,avarga,3.50,4,0,4
3532,yuhuh,,td172,1.32,81,-30,51
3529,what the,,bf172,1.32,99,-51,48
3528,oaidjioaiojfoijasoajoigfjoaise,,td172,1.33,39,-36,3
3526,Spiral 0-3,,denisb,2.65,22,0,22
3525,Langton's Highway,,avarga,2.82,6,0,6
3522,Painted Reflections,,axorion,3.27,14,-1,13
3521,Forbidden,,juanpablo,2.57,1,-5,-4
3520,Lucky four-leaf clover,,denisb,3.00,19,0,19
3519,Broken mirror,,denisb,2.77,10,-4,6
3518,Mirror in the mirror,,denisb,2.45,12,-2,10
3517,lots of stars,,rusty38,1.35,54,-23,31
3515,Frames,,mitakyt,1.86,20,-10,10
3514,Radnom puzzle,,mitakyt,1.77,21,-4,17
3512,Spring leaves,,denisb,2.94,17,0,17
3511,Knot II,,shaggy12,3.00,3,-1,2
3510,Knot,,shaggy12,3.08,7,0,7
3509,Full - Two in one,,denisb,3.00,1,-2,-1
3508,Gear,,benjaminrr,4.00,1,0,1
3507,Random,,denisb,3.09,8,-2,6
3506,Butterfly,,denisb,2.56,16,-1,15
3505,cool,,dashawnboard,1.67,13,-13,0
3504,Less is more,,denisb,3.09,7,-4,3
3499,Star,,dorian_gray,2.75,2,-1,1
3496,Confusing 5,,cat49,2.17,11,-7,4
3495,Chess knight trip ?,,dorian_gray,2.23,7,-5,2
3494,Jump !,,denisb,3.00,2,-1,1
3491,Identity (quadruple symmetry),,denisb,2.79,12,-1,11
3490,Double Symnetry,,denisb,2.42,20,-1,19
3489,Mirror mirror ...,,denisb,2.33,7,-5,2
3488,Three cushion billiards.,,denisb,2.06,13,-3,10
3485,Drive,,quinnbrown,3.40,4,-1,3
3484,Tribute to Sierpinsky,,denisb,2.70,5,-2,3
3483,Decoy 1.1,,axorion,3.08,10,-2,8
3482,Decoy,,axorion,2.03,21,-5,16
3474,Tenpenny tower!,,cat49,1.39,63,-18,45
3472,Alert Dragooon !,,denisb,1.78,11,-11,0
3471,Heart Attack,,axorion,3.00,3,-2,1
3470,First dragon,,denisb,1.75,25,-9,16
3467,smile,,rusty38,1.32,47,-20,27
3464,Heart full of love,,shaggy12,2.86,4,-2,2
3463,Logarithmic Spiral II,,shaggy12,4.00,0,0,0
3462,Thick Spiral,,shaggy12,1.91,27,-4,23
3461,Spirale 0-11,,denisb,2.27,10,-3,7
3459,Not so B AD (?),,denisb,2.43,6,-2,4
3458,A campain puzzle!,,cat49,1.31,94,-25,69
3456,OO(oops),,denisb,2.45,10,0,10
3454,Oupss,,denisb,3.14,6,-2,4
3453,Yet another almost full screen,,denisb,2.63,17,0,17
3452,Yet Another Spirale,,denisb,2.67,19,-1,18
3451,Random,,stewes,1.36,95,-44,51
3448,Triplicity,,axorion,3.25,3,0,3
3447,"Stripes, Stripes and Stripes!",,stewes,1.32,236,-86,150
3446,Duplicity,,axorion,2.29,5,-1,4
3445,Cave!,,cat49,2.21,11,-4,7
3444,Betrayal,,shaggy12,3.20,7,-1,6
3443,Over cross,,clem357,1.47,36,-13,23
3442,Locksmith,,axorion,2.89,6,0,6
3441,around we go!,,cat49,1.32,150,-69,81
3440,Treachery,,denisb,3.13,5,0,5
3439,Imitation,,axorion,3.25,13,0,13
3438,Reflection,,denisb,3.00,34,0,34
3437,Painting 2!,,cat89,1.36,46,-32,14
3436,Confusing 2!,,cat89,1.30,132,-40,92
3435,Astrology,,axorion,3.80,2,0,2
3434,Translate,,denisb,1.59,19,-14,5
3433,Yet another pyramid,,denisb,3.33,3,-2,1
3430,Yet another square,,denisb,2.33,8,-2,6
3429,Underworld,,cat49,1.30,146,-39,107
3428,Stairs,,cat49,1.33,240,-66,174
3427,Buildings 2,,cat49,1.39,91,-23,68
3425,One and an half,,denisb,2.77,12,-1,11
3424,Redwood,,denisb,2.26,17,-1,16
3423,Simpleton,,axorion,2.93,7,-4,3
3422,One star,,cat49,1.46,53,-20,33
3420,Pyramid,,denisb,1.97,23,-3,20
3419,Flame it,,denisb,1.83,13,-7,6
3418,Painting 2,,cat49,1.32,203,-51,152
3417,Vault 101,,cat49,1.60,44,-15,29
3416,Easy peasy!,,cat49,1.29,266,-58,208
3415,Birthday Cake,,shaggy12,2.80,11,-1,10
3414,Shift right,,denisb,2.22,22,-2,20
3413,Stair up and down,,denisb,1.53,49,-6,43
3412,Square,,denisb,2.06,24,-3,21
3411,Goldilocks 96/96,,axorion,3.75,1,-1,0
3410,Painting,,cat49,1.74,27,-5,22
3409,Buildings,,cat49,1.32,126,-40,86
3408,SMILE! ,,stewes,1.30,154,-81,73
3407,"Green, Red, Blue! Confused?",,stewes,1.34,73,-31,42
3406,??,,cat49,1.30,181,-58,123
3404,I don't know what this is but its COOL!,,cat49,1.32,87,-51,36
3403,Confuzzled,,stewes,1.75,33,-13,20
3402,The sword,,alexjeffries3,1.38,53,-29,24
3401,Water Droplet,,alexjeffries3,1.37,43,-35,8
3396,"Peace, Love, BUNNIES! :)",,stewes,1.41,76,-32,44
3395,SET,,stewes,1.30,117,-44,73
3394,Colorful Checkerboard,,stewes,1.31,430,-109,321
3393,Asymmetry 2,,axorion,3.80,6,0,6
3391,Holy Loop,,mt5090512,2.04,24,-3,21
3390,Staright to the Heaven..!!,,mt5090512,1.42,48,-16,32
3389,Dragunov 2,,mt5090512,1.54,25,-10,15
3388,Dragunov 1,,mt5090512,1.58,37,-8,29
3387,T-Bone ,,tyron123,1.33,129,-32,97
3385,?,,alexjeffries3,1.45,33,-27,6
3384,Around we go,,mintcc,1.30,480,-82,398
3383,Path,,mintcc,1.46,59,-13,46
3382,Dilemma,,shaggy12,3.75,1,-1,0
3380,*************,,trentminter,1.30,227,-89,138
3379,coby,,cobytaylor5,1.35,70,-53,17
3377,STARS LEAD THE WAY,,andres,1.30,421,-123,298
3372,cowboys rock,,matt4jesus07,1.30,234,-54,180
3370,the brain tezzer,,armondroyal,1.42,112,-30,82
3368,To Infinity,,shaggy12,3.43,6,0,6
3367,idk,,giants,1.30,194,-91,103
3366,Relative clauses II,,shaggy12,3.50,2,-1,1
3365,Puzzle Three,,nathanstill,1.88,11,-11,0
3364,Stripes and pits,,nathanstill,2.18,8,-8,0
3363,Patterns,,nathanstill,2.29,10,-6,4
3362,Impossible,,richardwilson,2.03,22,-9,13
3361,find the five,,richardwilson,1.41,60,-13,47
3358,Simple Sqare,,quinnbrown,1.34,154,-30,124
3356,Relative clauses,,shaggy12,3.00,4,0,4
3347,Asymmetry,,axorion,3.67,4,0,4
3346,snake,,giants,1.31,379,-70,309
3345,Weightlifting,,shaggy12,3.20,2,0,2
3344,Hello,,raider,1.46,42,-20,22
3343,Circle,,aidanwatkins,1.61,50,-19,31
3341,Criss Cross,,scout78,1.37,49,-24,25
3340,New York,,scout78,1.34,108,-39,69
3338,odd shape,,quinnbrown,1.49,50,-18,32
3337,colors,,quinnbrown,1.34,91,-31,60
3334,Verbose Simplicity,,axorion,3.43,5,0,5
3333,PLTW Puzzle 3,,pltwq,1.39,23,-25,-2
3332,PLTW Puzzle 1,,pltwq,1.31,261,-100,161
3331,How about iTTTT!,,aidanwatkins,1.29,72,-31,41
3329,Scratching Post,,axorion,3.33,4,0,4
3328,Purdue Sucks,,matt4jesus07,1.30,81,-42,39
3327,Journey to the center of the Earth,,shaggy12,3.13,7,-2,5
3326,Number Sign,,azure,4.67,3,-1,2
3325,Counterintuitive,,axorion,3.50,3,-2,1
3324,reuse me,,bkb0927,1.42,36,-24,12
3323,staples.........that was easy,,bkb0927,1.79,16,-6,10
3322,Mini USA Ish Thing,,wuzap,1.43,32,-27,5
3317,Triple Loop,,andres,1.61,52,-27,25
3316,Baylor Rocks,,matt4jesus07,1.32,140,-46,94
3315,Morning Glory II,,shaggy12,2.67,8,-1,7
3314,?????????,,matt4jesus07,1.67,43,-20,23
3313,Bwahahahahahahahahaha,,matt4jesus07,1.51,57,-19,38
3311,My Puzzle #2,,andres,1.31,377,-102,275
3309,Electricity,,shaggy12,4.00,2,0,2
3308,Morning glory,,shaggy12,3.10,7,-2,5
3305,Magnetization,,shaggy12,2.90,6,-1,5
3303,Flame,,shaggy12,3.14,7,0,7
3302,Test 1,,morepowerfull,3.05,17,-1,16
3301,Pinwheel 2,,azure,3.11,7,-2,5
3300,Pinwheel,,azure,3.00,11,0,11
3299,Juggernaut,,benjaminrr,2.59,15,0,15
3298,Jongleur,,shaggy12,3.14,4,0,4
3297,whoops,,allurs,2.67,1,-2,-1
3296,Translation and stacking,,shaggy12,3.67,2,-1,1
3295,C,,mohre,2.92,10,0,10
3294,Routine Exercise,,axorion,3.25,6,-1,5
3293,Pedestrian,,axorion,3.08,9,-2,7
3292,Tepidity -- Ninja Star,,benjaminrr,1.65,54,-5,49
3291,Tepidity -- Cross,,benjaminrr,1.76,39,-4,35
3290,Tepidity -- Hallow Square,,benjaminrr,1.80,34,-6,28
3289,Tepidity -- Solid Square,,benjaminrr,2.76,19,-1,18
3288,Big Nose Larry,,carter,1.39,43,-40,3
3286,Run Of The Mill ,,axorion,3.29,13,-3,10
3285,Groove Coverage III,,shaggy12,4.33,2,-1,1
3284,Groove Coverage II,,shaggy12,4.00,2,0,2
3283,Best selection II,,shaggy12,4.00,1,0,1
3282,Best Selection,,shaggy12,3.57,6,0,6
3281,Colorful,,jaluk8,2.57,3,0,3
3280,Flizzy Flozzy,,axorion,3.33,3,0,3
3278,RGB,,axorion,3.00,8,0,8
3277,Can you find the Pattern?,,mohre,4.00,3,-1,2
3276,Binary Snake,,sticky,3.75,3,0,3
3275,8,,mohre,1.71,36,-5,31
3274,Groove coverage,,shaggy12,3.20,3,0,3
3273,????,,mohre,1.63,35,-12,23
3271,Gromole's Lock,,benjaminrr,2.71,7,0,7
3270,Torn Paper,,benjaminrr,3.07,13,0,13
3269,Snippets,,axorion,3.33,7,0,7
3268,BFS,,shaggy12,3.00,3,0,3
3267,X,,mohre,2.24,29,-1,28
3266,X,,mohre,1.85,22,-3,19
3265,Red Fox II,,shaggy12,3.50,2,-1,1
3264,Difference,,vv91,2.75,3,-2,1
3263,Second Time,,vv91,2.33,4,-5,-1
3262,Trichotomy II,,vv91,3.40,3,-1,2
3261,Red fox,,shaggy12,2.67,7,-2,5
3260,Christmas Gifts,,benjaminrr,2.35,14,-3,11
3259,Dagur is best! jiibbiii!,,thepuzzleman,1.36,86,-36,50
3258,"Wow,man!",,thepuzzleman,1.47,25,-12,13
3255,Trichotomy,,vv91,3.00,4,-1,3
3254,Christmas spirit,,shaggy12,2.50,6,0,6
3251,Two-line color,,uzumaxy,1.72,40,-5,35
3249,Easy Spiral,,uzumaxy,1.72,37,-9,28
3248,Spiral Manufacturing,,benjaminrr,2.69,9,-2,7
3247,Night sky full of stars,,shaggy12,3.75,0,0,0
3246,Logarithmic Spiral,,shaggy12,3.20,3,-1,2
3245,Random 4,,mathgoat,3.08,6,-3,3
3244,Rogue the 2nd,,benjaminrr,3.50,1,0,1
3243,JIRA-issues,,kraker,3.25,4,0,4
3242,Robbing the bank,,shaggy12,4.00,0,-2,-2
3241,Sweet Nectar,,benjaminrr,2.93,9,0,9
3240,Selective Manufacturing,,benjaminrr,3.38,12,0,12
3239,Pumping it up,,kraker,3.75,1,0,1
3238,Sky full with stars,,shaggy12,3.20,1,-1,0
3237,UFC Ring,,carrben12,3.00,7,-1,6
3236,Wide Path (From the Middle),,carrben12,3.00,5,-2,3
3235,Street traffic,,shaggy12,2.56,7,-1,6
3234,df,,santiagozubr,1.55,39,-20,19
3233,Southern Cross,,vitalstatistic,2.83,5,0,5
3232,Random 3,,mathgoat,2.60,5,-6,-1
3231,Random 2,,mathgoat,2.05,12,-9,3
3230,Random,,mathgoat,3.00,3,-2,1
3229,Forgotten?,,shaggy12,3.00,0,0,0
3228,2 codes,,gm101,1.46,24,-15,9
3227,Confusement park,,gm101,1.47,39,-19,20
3223,That's the basic idea,,gm101,1.85,35,-5,30
3222,BUDAMUM,,gm101,1.79,19,-13,6
3221,I'm back,,gm101,2.10,13,-6,7
3220,Watch Out,,juanpablo,3.00,4,-2,2
3219,easy as water,,juanpablo,1.72,62,-3,59
3218,Binary Stack II,,sticky,3.29,5,0,5
3217,Binary Stack,,sticky,3.50,7,0,7
3216,Stars afraid of red,,shaggy12,3.00,2,0,2
3215,A-MAZE-ing,,shaggy12,3.33,1,-2,-1
3214,S is for Shift,,kraker,1.51,50,-14,36
3213,Binary Binary,,sticky,3.88,8,0,8
3212,Bad Puzzle,,axorion,4.00,1,0,1
3211,Obstructions,,axorion,3.09,9,-1,8
3210,Extinguish the fire,,shaggy12,4.00,4,0,4
3209,Stocks...,,kraker,3.50,1,0,1
3206,Surprise Box,,shaggy12,3.60,4,0,4
3205,3 o'clock,,shaggy12,2.92,25,0,25
3204,Square Recursion,,azure,2.82,7,0,7
3199,5-4-3-3-3,,juanpablo,2.57,4,-2,2
3197,gm006 revisited,,azure,2.79,12,0,12
3196,Clover,,shaggy12,2.56,13,-1,12
3195,Wicked whirl,,kraker,3.13,7,0,7
3194,Emergency Exits,,kraker,3.25,6,-1,5
3193,Blue and Green vs Red,,shaggy12,3.67,2,0,2
3192,An Average Puzzle,,axorion,3.23,8,0,8
3191,Sink,,shaggy12,2.45,14,-3,11
3190,Every step Count,,juanpablo,5.00,1,0,1
3189,Lost in a labyrinth,,shaggy12,4.00,1,0,1
3188,5 Stars - The Original,,shaggy12,3.38,4,-1,3
3187,aMAZEing,,shaggy12,2.91,7,-2,5
3185,C al reves,,juanpablo,1.70,16,-13,3
3184,Retorno,,juanpablo,1.63,23,-18,5
3183,Blue spiral 2,,smylic,3.33,5,-1,4
3182,z003,,zerosnake0,4.60,4,-2,2
3181,z002,,zerosnake0,3.14,5,0,5
3180,z001,,zerosnake0,3.00,5,0,5
3179,Log on (and on),,kraker,3.67,1,0,1
3178,Gone in 60 seconds,,shaggy12,2.69,9,-2,7
3177,turn ,,twisted_pro,1.48,15,-9,6
3176,A Bug,,shaggy12,3.11,6,0,6
3175,Mr. Magoo,,axorion,2.80,2,0,2
3174,EASI2,,eqm95,1.32,101,-58,43
3172,Romeo and Juliet,,carrben12,3.44,6,-1,5
3171,Log 3,,kraker,3.67,1,0,1
3170,Blue spiral,,jouni,3.11,5,0,5
3169,Diminuendo,,kraker,2.78,17,-2,15
3168,Nonsense,,juanpablo,1.37,100,-38,62
3167,Gunfighting,,kraker,3.30,11,0,11
3166,Alberto Barney Gutierrez no puede,,juanpablo,1.45,56,-19,37
3165,Curvy path,,jouni,3.25,10,-1,9
3164,Test for beginners,,shaggy12,3.50,1,0,1
3163,Kite,,kraker,3.29,2,0,2
3162,Stretched duplicate,,jouni,3.20,22,0,22
3161,Horlepiep,,kraker,3.13,6,-1,5
3160,????,,benjaminrr,3.33,7,-1,6
3159,Eight-way path,,jouni,2.82,10,-1,9
3157,uajuco,,marcelogzz,2.09,10,-7,3
3156,Easy,,juanpablo,1.58,33,-15,18
3155,5,,juanpablo,1.41,68,-25,43
3154,Confuse,,juanpablo,1.87,25,-7,18
3153,Balrog 2,,shaggy12,2.18,7,-8,-1
3152,Halloween Cat,,benjaminrr,2.33,18,-3,15
3151,Halving the stack,,yaxlat,2.80,34,0,34
3150,Odd ro even?,,yaxlat,2.11,31,-2,29
3149,Counting spiral,,yaxlat,2.50,13,0,13
3148,37 stars,,yaxlat,2.79,8,-1,7
3147,Going around and around,,jouni,2.74,15,0,15
3146,Two-sided linked list,,jouni,3.75,9,0,9
3145,Count and stack,,yaxlat,3.25,10,-2,8
3144,Doulble or half?,,yaxlat,2.50,20,0,20
3143,Palm Tree,,shaggy12,1.69,19,-7,12
3142,Learning to count,,yaxlat,2.79,20,-1,19
3141,Counting stairs,,yaxlat,3.25,2,0,2
3140,Double counting,,yaxlat,3.17,4,0,4
3139,Stars,,jaluk8,1.43,86,-22,64
3137,Hook,,pulver,2.50,10,-2,8
3136,Palm,,shaggy12,3.22,7,0,7
3135,Round and round,,jaluk8,1.38,65,-14,51
3134,???,,jgzzaceves,2.56,22,-2,20
3133,Switching,,jaluk8,1.79,29,-7,22
3132,Point Of Know Return,,axorion,3.18,10,0,10
3131,The Creeper,,thypenguinz,1.37,62,-37,25
3130,APUZZLE,,wyrms,2.75,10,-2,8
3129,Top Stars,,kraker,3.00,6,0,6
3128,Rorschach's Ant,,axorion,3.33,2,0,2
3127,Hourglass,,axorion,3.07,18,0,18
3126,Omega 2,,shaggy12,4.25,2,0,2
3125,Twenty Four,,axorion,3.30,9,0,9
3124,Where is your house man?,,benjaminrr,3.09,9,0,9
3123,Hedge,,benjaminrr,3.50,3,0,3
3122,Paintless Ant,,kraker,3.33,1,0,1
3121,Easy tree,,pulver,3.50,13,0,13
3120,Azure Aversion,,axorion,3.45,11,0,11
3119,Rat Race,,benjaminrr,3.25,6,0,6
3118,Domesticated Ant,,kraker,2.56,23,-1,22
3117,Omega,,shaggy12,2.86,9,-2,7
3116,Minimal Music,,kraker,3.15,14,0,14
3115,Stars only on blue,,shaggy12,3.71,7,0,7
3114,Enigma,,axorion,3.43,5,0,5
3113,Powerful cross,,bernardot94,2.90,4,-3,1
3111,Hypotenuse,,slicertool,2.00,36,-2,34
3110,Non Sequitur 2,,axorion,3.13,6,0,6
3109,Pave Your Way II,,kraker,2.41,30,0,30
3108,Baker's Dozen,,axorion,3.25,2,0,2
3107,Pave Your Way,,kraker,3.30,6,-1,5
3104,5 Stars - Another One,,shaggy12,3.50,2,-1,1
3103,Unconditional Honesty,,axorion,3.50,7,-1,6
3102,Autumn,,kraker,2.44,25,0,25
3101,Unconditional Love,,axorion,3.25,5,0,5
3100,Counterfeit,,axorion,3.80,3,0,3
3099,Spring 9,,axorion,3.50,3,0,3
3098,5 Stars - Other,,shaggy12,2.88,13,0,13
3097,Spring 8,,sticky,3.33,3,0,3
3096,Yeah,,brad9110,1.81,24,-7,17
3095,5 Stars,,shaggy12,2.56,5,-1,4
3093,Spirals & Wiggles,,axorion,3.29,6,0,6
3092,Spirals & Corners,,benjaminrr,3.43,3,-2,1
3091,Spirals & Forks,,benjaminrr,3.30,8,0,8
3090,Treasure Map,,axorion,3.60,5,-1,4
3089,Spring 7,,axorion,3.67,1,0,1
3088,Friday Delight,,benjaminrr,3.25,6,-1,5
3087,Extrasensory Perplexion ,,axorion,4.33,6,0,6
3086,Clairvoyance,,axorion,3.86,6,-1,5
3085,Glic Eochair II,,benjaminrr,3.50,2,0,2
3084,Crazy X,,gu1tarkn1ght,1.43,58,-12,46
3083,stack-it-up,,logicphyber,2.67,9,-2,7
3081,Your Mother,,peterdrip,1.39,64,-28,36
3079,Red or Green?,,logicphyber,3.20,3,0,3
3078,C Sharpe,,gregminister,1.50,14,-12,2
3077,Helicopter,,gu1tarkn1ght,2.22,13,-1,12
3074,Either/Or,,ddodgen0,1.79,31,-6,25
3073,Funky Cross,,gregminister,1.46,34,-14,20
3071,switchtopia,,djsogywafles,1.43,24,-19,5
3068,lasso,,laxrat16,2.71,13,-3,10
3066,Hammer Time,,ddodgen0,1.42,52,-15,37
3065,Switch Tracks!,,ddodgen0,1.37,74,-18,56
3063,Stackie Wackie,,ddodgen0,1.79,30,-11,19
3062,Diamonback,,gregminister,1.81,20,-5,15
3061,Lock Down,,laxrat16,3.38,5,-3,2
3060,assingnment,,sdamico0,1.94,26,-5,21
3058,so many colors!!,,verypanic9692,1.90,13,-8,5
3057,Puzzle 1,,njlinnehan,1.93,27,-6,21
3054,Bloody Icicles,,koujaku,2.17,20,-4,16
3053,Find the Route,,smylic,2.89,8,-2,6
3052,Dichotomic Autonomy,,axorion,4.00,7,0,7
3051,Logo,,kraker ,2.56,23,-1,22
3050,Undoing,,kostova,3.33,5,-1,4
3049,star cluster,,onqt,2.83,2,-1,1
3048,Hatrick IV,,kraker,4.33,1,-1,0
3047,Keys,,benjaminrr,3.29,5,0,5
3046,domination,,karterphil,2.50,8,-2,6
3045,Hatrick III,,kraker,4.00,2,-1,1
3044,Outer Limits,,axorion,3.40,4,0,4
3043,Fiddlesticks,,onqt,2.56,12,-1,11
3042,A bottle of wine,,yaxlat,2.93,8,-2,6
3041,Awry Tangle,,axorion,3.33,2,0,2
3040,Hatrick II,,kraker,3.86,5,0,5
3039,broken grid,,onqt,2.41,18,-4,14
3038,A box of stars with a red shelled turtle,,yaxlat,1.92,28,-7,21
3037,One stripe,,yaxlat,1.71,31,-5,26
3036,stackerwacker,,yaxlat,3.00,9,-3,6
3034,And which way on red?,,onqt,2.30,11,-5,6
3033,Snake ,,yaxlat,1.30,156,-47,109
3032,Which way?,,onqt,2.06,21,-6,15
3031,Green dots of doom,,yaxlat,2.30,13,-4,9
3030,RecursrionStacker,,yaxlat,3.08,8,-1,7
3029,Hatrick,,kraker,5.00,2,-1,1
3028,Cattle prod,,yaxlat,2.75,22,0,22
3027,The L,,yaxlat,2.76,27,0,27
3026,Stairs and a corridor,,yaxlat,1.65,39,-7,32
3025,strangestack,,yaxlat,1.69,38,-6,32
3023,Three stripes,,yaxlat,1.61,38,-9,29
3022,Boxystack,,yaxlat,2.19,14,-3,11
3021,Tada,,d0td0td0t,1.61,53,-8,45
3020,tricky corner,,yaxlat,1.65,17,-10,7
3019,spiralman,,yaxlat,1.31,324,-97,227
3018,Forward then back,,yaxlat,1.53,86,-8,78
3017,Swipswap,,yaxlat,1.49,44,-7,37
3016,cvs-spiral,,yaxlat,1.56,43,-12,31
3015,Spiral Addict,,benjaminrr,3.20,3,-2,1
3014,The Red Ninja Star,,benjaminrr,2.56,4,0,4
3013,Necklace,,benjaminrr,3.17,9,0,9
3012,Double Wiggle,,axorion,3.33,5,0,5
3011,Sierpinski 1.1,,kraker,3.00,5,0,5
3010,Sierpinski,,kraker,3.20,3,-1,2
3009,Regular Ant,,kraker,3.20,10,0,10
3008,Thue‚ÄìMorse sequen,,smylic,4.75,4,0,4
3007,Spring 6,,keba,3.53,14,0,14
3006,Stair stack - Rectangle Unstack,,geniussavant,3.44,6,-1,5
3005,Asterix' knife 2,,axorion,3.25,6,-1,5
3004,Fibonacci Word,,smylic,4.33,3,0,3
3003,Snail,,benjaminrr,3.31,13,0,13
3002,Think Inside the Box,,benjaminrr,3.83,3,-2,1
3001,Big Chunk,,axorion,3.67,2,-1,1
3000,Equalizer,,kraker,2.86,5,0,5
2999,Crawler Stacker 2,,geniussavant,3.21,14,0,14
2998,Crawler Stacker,,geniussavant,2.70,24,-1,23
2997,Add a Couple,,kraker,3.17,3,-1,2
2996,Multifunctionality,,axorion,3.17,4,0,4
2995,Strangers,,zebraze,2.75,9,-4,5
2994,Maze Crazy,,wesley,1.59,89,-33,56
2993,Celtic Cross,,axorion,3.50,0,-1,-1
2992,The Rotator,,zetar,2.32,29,0,29
2991,Doris,,zetar,2.60,28,0,28
2990,Immunity,,axorion,3.55,8,0,8
2989,Blue spiral,,zetar,1.61,23,-7,16
2988,2008,,hansa,1.46,9,-13,-4
2987,Crawl & Double 4,,axorion,3.40,2,-1,1
2986,I'll deal with that later,,nail3728,1.90,19,-6,13
2985,Squares?,,higashi,3.67,1,-2,-1
2984,Crawl With Peace,,benjaminrr,3.00,4,-1,3
2983,Crawl & Double 3,,axorion,3.33,5,-1,4
2982,Telephone,,benjaminrr,2.58,24,0,24
2981,nicolas-2,,nicolas,1.48,50,-10,40
2978,Not so Pff...,,geniussavant,2.88,11,-3,8
2977,Crawl & Double 2,,smylic,3.00,6,-2,4
2976,The Broken Fan,,benjaminrr,2.72,14,-3,11
2975,Cross Hair,,benjaminrr,2.92,10,0,10
2974,Trifecta,,axorion,3.20,10,0,10
2973,H√©lices de Feu,,benjaminrr,3.23,13,0,13
2972,Me Too,,benjaminrr,3.50,3,-1,2
2971,Encryption,,kraker,4.25,2,0,2
2970,Easy maze,,nanaki404,1.54,56,-17,39
2969,Two Stack Fractal,,geniussavant,2.57,19,-3,16
2968,Crawl & Double 1.1,,axorion,2.18,9,-6,3
2967,Crawl & Double,,axorion,1.95,11,-7,4
2966,Subterranean Rift - Sinkholes,,axorion,3.71,8,0,8
2965,Odd Square Algorithm,,kraker,3.43,5,0,5
2964,Stars everywhere,,nanaki404,1.79,28,-16,12
2963,Hidden Agenda,,axorion,3.25,1,0,1
2962,Second Chance,,kraker,3.17,13,0,13
2961,lower case t,,jeshc,2.77,8,-1,7
2960,Fractal 2,,geniussavant,3.00,9,-1,8
2959,Fractal,,geniussavant,1.80,33,-3,30
2958,Reduction,,geniussavant,1.79,33,-7,26
2957,Two stacks,,geniussavant,2.36,19,-2,17
2956,Tripling,,geniussavant,2.47,15,-3,12
2955,Path of Darkness - Evil Twin,,axorion,4.33,1,0,1
2954,Tribonacci,,smylic,3.33,4,0,4
2953,Road Less Traveled,,benjaminrr,2.63,21,0,21
2952,Turning Tricks,,axorion,3.04,24,0,24
2951,Augmentation,,kraker,3.00,13,-1,12
2950,Trail of Shadows,,axorion,2.92,13,0,13
2949,Nested Recursion,,axorion,3.43,5,0,5
2948,Can you DO that?,,geniussavant,2.21,14,-3,11
2947,Again a little chaos,,anton_s,1.91,19,-12,7
2946,Path of Darkness - Wriggle,,keba,4.00,3,0,3
2945,Landing Party,,axorion,4.00,3,0,3
2944,Wheel of fortune,,kraker,3.71,3,-2,1
2943,the curse and the destruction,,geniussavant,2.92,11,0,11
2942,Pattern Buffer,,axorion,3.13,5,-2,3
2941,Triangle I,,benjaminrr,2.93,10,0,10
2940,54321,,kraker,3.15,10,0,10
2939,Stars at 7,,kraker,3.14,5,-1,4
2938,Woggle,,axorion,2.23,23,-2,21
2937,"Left on green, right on red",,smylic,3.63,8,0,8
2936,Balrog,,axorion,4.80,4,0,4
2935,Stars at 4,,kraker,3.14,4,-1,3
2934,12345,,kraker,2.86,2,-1,1
2933,To Much Twist,,globeofgeek,2.44,11,-1,10
2932,Barbules,,axorion,3.00,3,0,3
2931,Tree IV,,smylic,4.11,11,0,11
2930,Cearn√≥g,,benjaminrr,3.13,6,0,6
2928,Store Length II,,benjaminrr,3.33,6,0,6
2927,Gray 4,,keba,4.75,3,0,3
2926,Little Blue Binder,,axorion,4.60,3,-1,2
2925,Three Ring Binder,,axorion,5.00,4,0,4
2924,Star Resonance,,keba,2.89,9,0,9
2923,Sound Wave II,,benjaminrr,3.14,5,-2,3
2922,Grand Finale,,kraker,3.71,5,-1,4
2921,Niklas's awesome puzzle,,nickelbird,1.78,31,-7,24
2920,Protuberance,,kraker,2.06,29,-3,26
2919,Gaps IV,,kraker,2.40,8,0,8
2918,Cross Accelerator,,kraker,2.88,6,0,6
2917,Gray,,sticky,3.40,4,0,4
2916,Sprag ,,axorion,3.13,8,0,8
2915,*crawl*,,d0td0td0t,1.96,25,-4,21
2914,Ratchet,,axorion,3.50,4,-1,3
2912,"""&""",,arudo,2.77,7,-1,6
2911,Loose End Mimicry,,kraker,3.09,8,-2,6
2909,Yin Yang,,axorion,3.13,7,0,7
2908,Blocks III,,benjaminrr,3.11,6,-3,3
2907,stack,,sivsushruth,1.76,31,-9,22
2906,Simple Programming,,d0td0td0t,3.09,28,0,28
2905,Inverted stairs,,anton_s,1.71,34,-9,25
2904,Let¬¥s go !!! (part 3,,anton_s,2.28,27,-5,22
2903,"Small, but a bit confusing",,anton_s,3.50,2,-3,-1
2902,"Red, green, red, green...",,anton_s,1.68,86,-8,78
2901,Strata,,kraker,2.90,7,-1,6
2900,Spring 5,,sticky,3.88,8,0,8
2899,More or Less,,axorion,2.72,26,-1,25
2898,LadyBug,,benjaminrr,2.09,28,-3,25
2897,dooooooooom @@@@@@,,mrh11_20,1.31,390,-88,302
2896,hi,,mrh116michael,1.30,54,-25,29
2888,Loose Change,,axorion,4.50,1,-1,0
2883,Loose Ends VII,,kraker,3.07,14,0,14
2882,??????????????????,,mrh114bryan,1.67,56,-15,41
2879,Off to see the Wizard,,gibbs,1.57,52,-19,33
2878,A Loose Interpretation,,axorion,3.38,5,-2,3
2877,Thick Loose End II,,kraker,3.00,14,0,14
2876,Pole Vault,,axorion,3.50,5,-2,3
2875,Loose Ends VI,,kraker,3.50,5,-3,2
2874,X factor,,tonse,1.75,32,-11,21
2873,Spring 4,,sticky,3.56,11,0,11
2872,legs,,jfm0520,1.64,41,-5,36
2871,windmill,,jfm0520,1.88,43,-2,41
2870,krijnen,,tonse,1.91,35,-5,30
2869,Confusing,,anton_s,3.09,10,-2,8
2868,ehhh,,ashwin_12,1.30,133,-50,83
2867,easy!!,,ashwin_12,1.31,140,-66,74
2866,gm038,,gm101,1.73,31,-9,22
2865,gm037,,gm101,1.35,139,-40,99
2864,gm036,,gm101,1.43,53,-20,33
2863,Shaded Pole,,axorion,3.13,14,0,14
2862,FG,,wongman,1.33,187,-40,147
2861,More Blocks,,kraker,3.17,10,0,10
2860,Thick Loose End,,kraker,4.29,2,-1,1
2859,Time Bandit,,axorion,4.50,1,0,1
2858,Guus snapnie,,tonse,1.76,35,-7,28
2856,Loose Ends V,,kraker,3.11,4,-1,3
2855,Blocks II,,benjaminrr,2.42,23,-1,22
2854,Blocks,,benjaminrr,2.30,28,-1,27
2853,path,,sivsushruth,2.88,4,-3,1
2852,Which way? 2,,anton_s,2.02,30,-6,24
2851,Unusual cross,,anton_s,2.62,25,-1,24
2850,Cheap Handcuffs ,,axorion,3.70,10,-1,9
2849,Handcuffs,,benjaminrr,3.23,9,-1,8
2848,Pendant Defect,,benjaminrr,1.98,53,0,53
2847,cul-de-sac,,benjaminrr,3.13,15,-1,14
2846,andrei,,andrei99,1.41,71,-36,35
2845,gm034,,gm101,1.52,46,-18,28
2844,gm033,,gm101,1.40,96,-23,73
2842,Interlock 2,,axorion,4.75,2,0,2
2841,Loose Ends IV,,kraker,2.86,11,0,11
2840,Interlock ,,axorion,4.33,3,-2,1
2839,Loose Ends III,,kraker,3.43,4,0,4
2838,"The puzzle is small, isn¬¥t it",,anton_s,4.40,2,-2,0
2837,The Man With One Red Shoe,,axorion,2.67,11,-1,10
2836,Loose Ends II,,kraker,4.00,0,-1,-1
2835,The Child,,axorion,3.30,11,0,11
2834,The Mother,,axorion,3.40,8,0,8
2833,The Father,,axorion,2.80,9,0,9
2832,4 Hole Golf Course -- Flagsticks,,benjaminrr,3.29,22,0,22
2831,Dyslexicon,,axorion,3.09,8,-2,6
2830,andrei5,,andrei99,1.32,187,-70,117
2829,Whirling Dervishes ,,kraker,2.68,26,0,26
2826,andrei2,,andrei99,1.84,47,-3,44
2824,Langton‚Äôs Fickle Au,,axorion,3.60,3,0,3
2823,Langton's Dizzy Uncle,,axorion,2.89,10,0,10
2822,Loose ends,,kraker,?,0,0,0
2821,Gun Crazy,,benjaminrr,3.29,5,-1,4
2820,Knot Of This Whirled,,axorion,3.88,6,-1,5
2819,Crazy guns,,kraker,2.67,13,-3,10
2818,Crazy gun,,nevzor,3.00,10,0,10
2817,Which way? ,,anton_s,1.51,48,-15,33
2816,Cat Scat,,axorion,3.67,4,0,4
2815,Codes Trip,,axorion,3.80,5,0,5
2814,Code strip II,,kraker,3.45,11,0,11
2813,Black hole lite,,kraker,3.00,5,0,5
2812,Code strip,,kraker,3.29,28,0,28
2811,Proliferating black holes,,kraker,3.50,2,0,2
2810,Minimal lengthening,,kraker,2.09,48,-5,43
2809,gm032,,gm101,1.60,26,-17,9
2808,gm031,,gm101,1.87,20,-13,7
2807,Experiment,,gm101,1.39,106,-30,76
2806,Black hole,,kraker,3.17,3,0,3
2805,patterns of randomness,,supercat765,3.00,1,0,1
2804,Blue in red,,radek,2.17,31,-4,27
2803,Generic Stacker,,axorion,2.67,10,-1,9
2802,Turning Points,,axorion,3.22,7,-2,5
2801,"One, two, wait, no, zero",,ivodankolov,2.71,11,0,11
2800,Avalanche,,kraker,2.73,23,0,23
2799,Color Your Flower,,benjaminrr,3.25,5,-2,3
2798,gm030,,gm101,1.47,46,-28,18
2797,LeandroJF this is for you,,gm101,1.50,55,-21,34
2796,gm029,,gm101,1.37,92,-44,48
2795,gm028,,gm101,1.31,200,-83,117
2794,gm027,,gm101,1.35,84,-40,44
2790,Nothing new,,kraker,2.00,25,-2,23
2789,gm023,,gm101,1.55,16,-10,6
2785,gm018,,gm101,1.50,10,-8,2
2784,gm017,,gm101,1.61,8,-8,0
2783,gm016,,gm101,2.00,22,-8,14
2780,gm014,,gm101,1.50,39,-17,22
2779,gm013,,gm101,1.34,73,-34,39
2776,gm010,,gm101,1.38,62,-25,37
2775,gm009,,gm101,1.62,44,-12,32
2774,Optimus Derivative,,axorion,3.60,3,0,3
2773,Inversions,,kraker,1.88,28,-6,22
2772,In & Out of Stackspace II,,kraker,3.13,11,-1,10
2771,In & Out of Stackspace,,kraker,3.07,13,-1,12
2770,gm008,,gm101,1.30,118,-37,81
2768,gm006,,gm101,1.34,61,-43,18
2767,gm005,,gm101,1.42,90,-26,64
2764,gm002,,gm101,1.75,30,-12,18
2763,gm001,,gm101,1.63,17,-17,0
2762,Another red box,,gm101,1.36,49,-21,28
2758,Underpass,,gm101,1.62,54,-8,46
2757,Alternator,,axorion,3.44,10,0,10
2756,L is real 2401,,gm101,1.90,6,-10,-4
2755,Room Searcher,,benjaminrr,2.88,9,-1,8
2754,Random 1,,cristi003,1.31,161,-86,75
2753,Shifts,,kraker,2.80,9,0,9
2751,Decoration,,kraker,3.80,1,0,1
2749,Paintstack,,kraker,3.50,2,0,2
2748,wtf,,suhail,1.38,132,-45,87
2747,A chaos of colours,,anton_s,3.80,1,-1,0
2746,Peano sqr,,flubberix,1.84,26,-8,18
2745,Another Windmill,,qinn,4.00,3,0,3
2744,Salamander,,kraker,2.83,7,-4,3
2742,Sideway Biuldings,,gm101,1.31,169,-50,119
2741,just an excuse to make a one more puzzle,,gm101,1.32,140,-52,88
2740,The fun little wee,,gm101,1.49,51,-17,34
2739,Green in a box of red,,gm101,1.36,121,-16,105
2738,Bromidic Platitud,,axorion,3.12,26,0,26
2737,Tower Defence,,axorion,3.40,4,0,4
2736,Wide Parallel Lines,,benjaminrr,3.29,5,-2,3
2735,Maze Mapping,,benjaminrr,3.57,4,-1,3
2734,Paradiddle Introduction,,benjaminrr,2.50,17,-1,16
2733,Stack-extra,,kraker,3.00,24,0,24
2732,BlueBerry Picking,,benjaminrr,3.00,31,0,31
2731,Strangely object,,anton_s,2.00,34,-4,30
2730,Arbre,,benjaminrr,3.33,12,-1,11
2729,Data Spiral Transfer,,benjaminrr,3.63,5,0,5
2728,The X without difficulties,,anton_s,1.65,42,-9,33
2727,Flick the Switch,,nail3728,1.70,34,-11,23
2726,Up and Down,,nail3728,1.83,39,-3,36
2725,Gaps III,,kraker,3.60,3,-1,2
2724,Maze,,nail3728,1.35,58,-24,34
2723,Trailing Tree,,zetar,1.51,48,-18,30
2722,spacefiller ant. guessing involved.,,kapla,4.25,2,-1,1
2720,Gaps II,,kraker,3.25,1,-1,0
2718,,,kapla,3.20,7,-2,5
2713,Please make this blue & green,,kapla,1.77,54,-8,46
2712,s,,kapla,3.05,18,0,18
2711,noname,,kapla,1.57,74,-15,59
2710,i love bees,,kapla,1.36,155,-36,119
2709,langton`s ant,,kapla,3.43,2,-2,0
2708,tricky stack,,kapla,2.11,22,-10,12
2707,Gaps,,kraker,3.25,1,0,1
2706,Game Over -- Please Insert Coin,,benjaminrr,2.94,15,-1,14
2705,Eastern Constellation,,axorion,3.00,13,0,13
2704,3 Stars,,hansa,1.68,50,-8,42
2703,Remote star,,kraker,2.70,6,-1,5
2701,Ministack,,kraker,2.50,20,-1,19
2699,Only a square,,anton_s,1.96,53,-1,52
2698,Foursquare,,axorion,3.14,4,-1,3
2697,Schooner,,axorion,3.08,8,0,8
2696,Arrow,,kokalishte,2.00,23,-4,19
2695,Elbow Room,,axorion,3.18,10,0,10
2694,Countdown,,kraker,3.63,6,-1,5
2693,Over the hills and...,,kraker,1.76,23,-10,13
2692,Stack Magic: variation,,smylic,3.50,4,0,4
2690,Short Dizzy Distance,,sticky,3.43,15,-2,13
2689,Neophyte ,,axorion,2.52,21,-1,20
2688,wtf,,1987ronnie,1.36,115,-74,41
2687,Pushing Teal,,axorion,3.14,13,0,13
2686,Pants,,kraker,3.43,4,-2,2
2684,Let¬¥s go !!! (part 2,,anton_s,2.79,13,-2,11
2683,That is not a labyrinth,,hansa,1.74,40,-7,33
2682,Simple cross,,anton_s,1.95,30,-8,22
2681,Welcome in the easy puzzle,,anton_s,1.75,70,-4,66
2680,One for Axorion,,anton_s,2.78,14,-1,13
2678,Big stairs,,anton_s,2.30,28,-2,26
2677,TJRTCWHIYJM%vbembwgwlol rdfgbw wow...[I),,gm101,1.38,78,-32,46
2676,Fractal Frustration II,,qinn,4.00,3,-1,2
2675,Tetris101,,akxx,4.00,1,0,1
2674,Fractal Frustration,,qinn,3.45,8,-1,7
2673,One for Anton,,axorion,2.33,21,-2,19
2672,Signs in the puzzle 2,,anton_s,1.78,28,-12,16
2670,3 Spirals,,anton_s,2.22,27,-1,26
2669,up then down,,dovie,1.31,438,-102,336
2668,Green and Red 6x6,,axorion,3.00,7,-1,6
2667,Easy Green and Red 2,,anton_s,1.41,108,-17,91
2666,Green is nerved,,anton_s,2.13,29,-1,28
2665,Back to Basics,,axorion,3.08,12,0,12
2664,Leaving Heaving,,skouboe,2.37,26,-2,24
2663,Easy,,skouboe,1.92,12,-5,7
2662,Not That Easy Green and Red II,,qinn,3.33,0,0,0
2661,Here is strategy,,anton_s,2.38,13,-3,10
2660,A chaos,,anton_s,2.73,8,-3,5
2658,Not That Easy Green and Red,,qinn,3.00,3,-2,1
2657,Curios,,anton_s,3.50,5,-1,4
2656,Popcorn,,axorion,3.12,15,0,15
2655,Mystery?,,anton_s,1.64,43,-7,36
2654,Easy Green and Red,,anton_s,1.44,96,-14,82
2653,Quadrant,,axorion,3.27,13,0,13
2652,Christmas Present,,atenthehutt,3.13,3,-2,1
2651,More ways,,anton_s,3.14,8,0,8
2650,Not spiral ,,anton_s,2.82,10,-2,8
2649,A blue cross in the middle,,anton_s,2.64,19,-4,15
2648,Recursion again,,ryo1099,1.44,269,-51,218
2647,"Priorities, priorities.",,ryo1099,1.31,401,-88,313
2646,A mad face,,anton_s,2.25,17,-5,12
2645,Again a spiral,,anton_s,1.80,19,-11,8
2644,Green looks Good,,onqt,1.56,34,-8,26
2643,Without the cross,,anton_s,1.41,85,-10,75
2642,Long line,,anton_s,2.06,28,-2,26
2641,A another spiral,,anton_s,3.33,6,-1,5
2640,Labyrinth,,anton_s,2.71,13,-1,12
2639,Flippity Floppity,,axorion,3.60,4,0,4
2638,Done again a spiral,,anton_s,2.23,31,-2,29
2637,n-squared,,ruilov,2.93,11,-1,10
2636,Supertramp,,axorion,3.11,7,0,7
2635,My 100th puzzle,,anton_s,2.18,15,-6,9
2634,Interesting or boring?,,anton_s,2.48,20,0,20
2633,For a 3-D Program Puzzle...,,vaati,1.29,633,-165,468
2632,A abnormal design,,anton_s,3.50,3,-1,2
2631,Upstairs,,anton_s,1.95,25,-4,21
2630,Green Hooks,,axorion,3.29,5,0,5
2629,Strange squares,,anton_s,1.40,69,-9,60
2628,Random Stack,,vaati,1.37,113,-36,77
2627,Find the best way (part 3),,anton_s,3.50,0,-1,-1
2626,A bit problem in the spiral,,anton_s,2.56,16,0,16
2625,More cross,,anton_s,2.67,14,0,14
2624,A very strange cross,,anton_s,2.32,28,0,28
2623,It must have been love,,carrben12,3.00,13,0,13
2622,A bit green in the puzzle,,anton_s,2.31,36,-2,34
2621,A little F2,,anton_s,3.00,15,-1,14
2620,Solve it!,,gm101,1.38,56,-32,24
2619,Reverse the spiral,,gm101,1.70,29,-8,21
2616,Wires,,streetmime,2.92,10,-1,9
2615,And so forth,,anton_s,2.35,26,-3,23
2614,Big colourful spiral,,anton_s,2.03,35,-2,33
2613,You can start now!,,anton_s,1.73,35,-5,30
2612,quest for the red star 3,,onqt,1.65,28,-10,18
2611,Something is missing,,anton_s,2.90,7,-2,5
2610,Four Star Challenge 2,,axorion,3.71,4,-1,3
2609,More strange cross,,smylic,3.86,5,0,5
2608,A strange cross,,anton_s,2.54,25,0,25
2607,A mad puzzle,,anton_s,1.50,78,-13,65
2606,quest for the red star 2 ,,onqt,2.75,8,-1,7
2605,My fantasy puzzle,,anton_s,2.67,18,0,18
2604,Left or Right?,,mooofdoom,2.58,22,0,22
2601,(not-so) Pathetictly easy 6,,gm101,1.43,79,-32,47
2600,Patheticly easy 5,,gm101,1.39,45,-32,13
2595,The S (for symlic),,gm101,1.80,27,-9,18
2594,A cross,,gm101,1.58,66,-8,58
2593,Addition 2,,ruilov,2.02,36,-1,35
2592,test,,ruilov,2.07,17,-7,10
2591,Addition,,ruilov,3.00,13,-2,11
2590,Follow the field !,,anton_s,3.33,5,0,5
2589,Two Reds Part 3,,mooofdoom,2.76,14,-1,13
2588,Two Reds Part 2,,mooofdoom,2.13,21,-5,16
2587,What is that?,,anton_s,1.76,43,-7,36
2586,quest for the red star,,onqt,2.29,10,-3,7
2585,Two Reds,,mooofdoom,2.38,22,-1,21
2583,Vertical Segments,,axorion,3.60,3,0,3
2582,Nightmares For Nonstackers,,axorion,3.17,5,0,5
2581,cold cross,,onqt,1.62,43,-11,32
2580,Double spiral,,anton_s,1.66,38,-9,29
2578,"Left and right, up and down",,anton_s,2.69,6,-6,0
2577,Let`s go !!!,,anton_s,2.35,28,-2,26
2576,Use red !!!,,anton_s,2.78,19,-3,16
2575,Strange spiral 3,,anton_s,2.86,17,0,17
2574,go straight then u-turn,,jansson,1.54,55,-18,37
2573,c xc,,rezil,1.52,42,-12,30
2572,<zx,,rezil,1.32,648,-141,507
2571,It¬¥s showtime,,anton_s,2.04,26,-4,22
2570,far away,,jansson,1.41,81,-30,51
2569,Seven Eleven,,axorion,2.72,15,0,15
2568,Colormaze,,lbrande,1.74,44,-8,36
2567,Trilithons of Baalbek,,axorion,3.70,10,0,10
2566,Ways and spirals,,anton_s,2.50,17,-1,16
2565,Take the stars,,anton_s,2.38,16,-5,11
2564,Temple of Bacchus,,axorion,4.67,4,0,4
2563,Foursquare puzzle is back,,anton_s,2.69,11,-2,9
2562,Doubled Stack,,vaati,1.79,45,-4,41
2561,Find the best way (part 2),,anton_s,3.00,7,-1,6
2560,Can you see the star?,,hansa,3.18,6,-2,4
2559,2011 A new year,,anton_s,1.64,34,-10,24
2558,Lots of stairs,,anton_s,2.56,15,-1,14
2557,Find the best way ,,anton_s,3.00,13,-1,12
2556,Stars line,,anton_s,1.80,52,-3,49
2555,Trigger,,sticky,3.75,1,0,1
2554,Twist's in the road,,gm101,1.31,429,-97,332
2552,A Really interesting puzzle,,gm101,2.78,4,-2,2
2551,The star is very high,,anton_s,2.25,25,-1,24
2550,Love,,hansa,1.65,62,-9,53
2549,Follow the Stars,,mooofdoom,2.53,16,-1,15
2548,A Cordial Invitation,,axorion,2.62,20,0,20
2547,Strange spiral 2,,anton_s,2.07,57,-3,54
2546,What you can do?,,anton_s,2.95,14,0,14
2545,The Sixteenth Power 2,,smylic,3.00,3,0,3
2544,The Sixteenth Power,,smylic,3.40,5,0,5
2543,Accumulating Corners,,axorion,3.18,10,0,10
2542,Puzzle time,,anton_s,2.55,15,0,15
2541,Big Tree,,qinn,3.67,9,0,9
2540,WTF?!,,ihatemac,2.64,7,-2,5
2539,A Black Tile Affair,,axorion,4.00,5,0,5
2538,Number Sequence,,smylic,5.00,1,0,1
2537,The Grinch,,techteach514,1.82,19,-9,10
2536,\sqrt{5} Steps From The Road,,smylic,2.67,5,-2,3
2535,Bit Count 3,,smylic,3.50,1,-1,0
2534,Bit Count 2,,smylic,3.75,3,0,3
2533,Sequence Spiral,,qinn,3.83,6,0,6
2532,Easy Pweasy,,twigster,1.30,318,-67,251
2531,Least power of 2,,smylic,3.00,4,0,4
2530,colourgame difficult,,tier,3.00,5,-4,1
2529,colourgame,,tier,2.93,13,0,13
2528,Time to play,,ncis,2.19,11,-10,1
2527,Run Around,,twigster,4.50,1,-2,-1
2526,Rainbow Tree,,keba,3.29,5,-1,4
2525,Ding Dong,,twigster,1.53,48,-30,18
2523,Three Phase 2,,axorion,2.57,27,-1,26
2522,Breadcrumbs,,10r4x,1.62,56,-8,48
2520,gozluklu,,rezil,1.31,76,-26,50
2519,d√∂n dola,,rezil,1.83,18,-11,7
2518,connects,,onqt,2.58,16,-2,14
2517,Huh?,,wongman,1.47,22,-21,1
2516,rg,,wongman,1.91,27,-10,17
2514,Cut In The Middle,,smylic,3.20,6,0,6
2513,Crossings and T-turns,,benjaminrr,3.33,6,-2,4
2512,Aztec Mask,,axorion,3.22,7,-2,5
2511,Spiral 6,,benjaminrr,3.00,7,-2,5
2510,"Again, Some Fun",,benjaminrr,3.19,10,-2,8
2509,Colorful Spiral,,jfm0520,1.33,246,-43,203
2508,Fun,,benjaminrr,3.33,12,-1,11
2506,The American Flag in 9999,,wongman,1.47,38,-21,17
2504,stuff,,godcoder,2.30,11,-3,8
2502,The Gateway,,jfm0520,2.00,30,-3,27
2501,Lollipop,,jfm0520,2.11,20,-8,12
2500,Pingas,,desultima,2.09,25,-7,18
2499,simpler than it looks,,spliffen,1.38,111,-33,78
2498,Another PYOP (v2),,keba,4.00,4,0,4
2497,Reuben ,,axorion,3.25,9,-1,8
2496,Another PYOP,,axorion,3.27,9,0,9
2495,chicken,,estone,1.51,41,-30,11
2483,Foursquare puzzle 2,,anton_s,2.06,23,-8,15
2482,Polly Want A Cracker?,,benjaminrr,3.05,39,0,39
2481,Colour problem !!!,,anton_s,3.00,9,-2,7
2480,Strange spiral,,anton_s,2.75,18,-2,16
2479,Remembrance Day,,benjaminrr,2.05,33,-2,31
2478,Colour spiral,,anton_s,1.49,24,-14,10
2477,Colour mountains,,anton_s,1.78,41,-9,32
2476,There and Back Again,,axorion,3.05,23,0,23
2475,Double Hammered,,qinn,3.44,6,-1,5
2474,Colour way,,anton_s,1.97,36,-2,34
2473,New idea,,anton_s,2.43,23,-3,20
2472,Up and down,,hansa,2.03,36,0,36
2471,Two ways,,anton_s,2.68,29,0,29
2470,Picture puzzle,,anton_s,2.05,26,-8,18
2469,Shape Shifter,,axorion,4.00,4,0,4
2468,5 Ways,,anton_s,2.69,38,0,38
2467,Magic square,,anton_s,1.90,60,-1,59
2466,F'ed Up,,qinn,3.33,8,0,8
2465,Overlapping Doublers,,axorion,3.25,4,0,4
2464,Foursquare puzzle,,anton_s,1.88,71,-2,69
2463,Green is not my friend,,hansa,1.72,47,-5,42
2462,My 50th ,,anton_s,2.29,35,-7,28
2461,THE ED,,gm101,1.30,58,-29,29
2459,Blue - Blue,,jaex,3.17,21,0,21
2458,Once or Twice,,axorion,3.00,24,0,24
2457,Climber,,anton_s,1.41,130,-21,109
2456,Free Victory!,,benjaminrr,2.42,24,0,24
2455,To the Green Square,,benjaminrr,3.27,11,0,11
2453,Wind Flower,,jaex,3.06,16,0,16
2452,Green and Blue vs Red,,anton_s,5.00,0,-2,-2
2451,4 Binary Digits,,jaex,3.67,5,0,5
2450,Find the way,,lucjansz,2.19,18,-6,12
2449,zero in,,onqt,1.72,49,-16,33
2448,Scary puzzle,,hansa,5.00,0,-3,-3
2447,Madness,,anton_s,4.17,3,-4,-1
2446,Ugly Spiral,,jaex,2.62,32,0,32
2445,F'ed Up and Down II,,qinn,4.25,5,0,5
2444,F'ed Up and Down,,qinn,4.00,2,0,2
2443,Blue kill Green ,,hansa,1.40,116,-26,90
2442,2012,,anton_s,1.48,74,-20,54
2441,Colour stairs,,hansa,1.52,67,-17,50
2440,EZX,,axorion,3.13,17,0,17
2439,Loyal puzzle,,anton_s,1.96,55,-3,52
2438,Conditions,,jaex,3.38,9,-2,7
2437,Perilous Parities 2,,axorion,3.09,9,0,9
2436,Little Alien,,jaex,2.68,20,-1,19
2435,Scorpion,,jaex,3.40,2,-3,-1
2434,Mini galaxy,,anton_s,1.32,45,-21,24
2433,Ravine,,anton_s,1.50,63,-32,31
2432,Follow green and red,,anton_s,2.50,9,-5,4
2431,In a another end,,anton_s,1.33,179,-39,140
2430,Blue line,,anton_s,1.50,75,-22,53
2429,New galaxy,,hansa ,2.64,10,-2,8
2428,Milestone,,axorion,1.84,17,-12,5
2427,Forgive Keba,,axorion,2.55,21,-1,20
2425,Way of the colours,,anton_s,2.46,18,-4,14
2424,Broken Symmetry,,jaex,2.42,34,-1,33
2423,Starship,,jaex,3.14,7,-1,6
2421,Mysterious Box,,jaex,3.57,8,-1,7
2420,2 Bearing,,anton_s,1.88,35,-8,27
2419,First & Last Color,,jaex,2.29,33,-1,32
2418,Green Squares,,jaex,3.67,4,0,4
2417,Three Times,,jaex,2.82,11,-1,10
2416,There and Back,,jfm0520,2.04,19,-4,15
2415,Hole In The Middle,,jfm0520,1.42,107,-31,76
2412,Easy puzzle for beginner 5,,anton_s,1.69,58,-11,47
2411,Easy puzzle for beginner 4,,anton_s,1.33,211,-58,153
2410,Easy puzzle for beginner 3,,anton_s,1.32,282,-54,228
2409,Easy puzzle for beginner 2,,anton_s,1.30,717,-153,564
2406,Snake,,anton_s,1.34,63,-59,4
2405,A long way 3,,anton_s,1.62,57,-26,31
2404,Blame Keba,,axorion,3.75,2,0,2
2402,A long way 2,,anton_s,1.75,42,-15,27
2401,Decipher,,jaex,3.86,2,0,2
2400,colored square (2),,onqt,1.44,34,-25,9
2399,colored square,,onqt,2.07,28,-3,25
2398,Stack Residue,,axorion,3.27,11,0,11
2397,Incomplete Kite,,jaex,1.87,30,-5,25
2396,Red Leaves,,jaex,2.93,10,-2,8
2395,Down & Up 2,,jaex,3.13,14,-2,12
2394,stickman,,jek456,1.31,114,-32,82
2391,pff,,mnijoe,1.78,31,-7,24
2390,Simple Math,,jaex,3.00,21,-2,19
2389,Skyscrapers II,,qinn,4.00,9,0,9
2388,A long way,,anton_s,1.52,65,-19,46
2387,Down & Up,,jaex,3.13,14,-1,13
2386,Tower,,anton_s,1.66,58,-13,45
2385,Go!,,anton_s,1.67,60,-12,48
2384,Green-Blue Galaxy,,anton_s,1.65,38,-12,26
2383,Double E,,anton_s,1.72,48,-21,27
2381,Colorful Spiral,,jfm0520,2.00,26,-5,21
2380,submarine,,onqt,2.43,17,-5,12
2379,Flag Strips,,jfm0520,2.54,17,-4,13
2378,Skyscrapers,,qinn,3.67,18,0,18
2377,A new legend,,anton_s,2.38,19,-3,16
2376,Square Crosshair,,jaex,1.57,60,-8,52
2375,Incomplete Window,,jaex,2.70,22,-1,21
2374,stair case,,jkjoshing,1.63,53,-8,45
2373,Push U Turns,,jaex,3.40,9,-1,8
2372,herro,,t00hey16,2.89,4,-2,2
2371,x,,godcoder,1.42,171,-55,116
2368,For Edsaw,,igpay,2.45,22,-4,18
2367,the hardest one yet,,kevingelston,1.33,222,-52,170
2365,Good Evening,,anton_s,1.80,45,-16,29
2364,Little mountain,,anton_s,1.79,34,-10,24
2363,Red street,,anton_s,2.43,6,-4,2
2362,Big 5,,anton_s,2.00,37,-3,34
2361,Hard stairs,,anton_s,2.52,19,-3,16
2360,Top star,,anton_s,2.56,11,-9,2
2359,Amercican flag,,mister_x330,1.79,28,-14,14
2357,simple code456,,jek456,1.30,131,-36,95
2356,"There on Blue, Back on Green",,jfm0520,1.75,37,-5,32
2355,take ur time,,godcoder,1.77,5,-6,-1
2354,swimming fish,,anton_s,2.20,24,-4,20
2353,border,,anton_s,1.48,62,-16,46
2352,colour picture,,anton_s,2.79,12,-5,7
2351,Green World 3,,anton_s,3.57,1,-4,-3
2350,Nation,,anton_s,2.57,8,-2,6
2349,Valley Night,,axorion,2.95,22,0,22
2348,"Red, the box is",,gm101,1.89,15,-11,4
2347,Simple Loop,,jaex,1.40,207,-35,172
2346,Color Patterns,,jaex,2.89,6,-1,5
2345,box,,jfm0520,3.33,4,-1,3
2343,Follow Road,,jaex,3.00,6,0,6
2342,Green World 2,,anton_s,1.40,88,-28,60
2341,Galaxy,,anton_s,3.00,4,-4,0
2340,Hour Glass,,jfm0520,1.35,200,-26,174
2339,Come-Back Spiral,,jfm0520,1.69,33,-14,19
2338,X-Factor,,jfm0520,1.76,38,-5,33
2336,deep blue see,,anton_s,2.00,14,-14,0
2335,draw it!,,anton_s,1.78,48,-10,38
2334,Rose,,jaex,2.06,25,-5,20
2333,Mask,,jaex,3.00,12,0,12
2331,Alien,,jfm0520,1.32,98,-38,60
2330,magic wand,,jfm0520,1.43,90,-22,68
2329,October,,axorion,3.00,10,-1,9
2328,Four Star Challenge,,axorion,3.20,17,0,17
2327,Yet another one made by gm101,,gm101,1.76,16,-11,5
2326,Simple Delay,,jaex,2.91,7,-2,5
2325,Square Object,,jaex,1.56,196,-14,182
2323,4-Jan,,jaex,3.07,10,-1,9
2322,Up & Down 2,,jaex,3.17,4,-1,3
2321,Up & Down,,jaex,2.14,18,-1,17
2320,Two Flower,,jaex,3.07,8,-2,6
2319,Follow Colors,,jaex,2.85,18,-1,17
2318,flower,,anton_s,1.39,189,-28,161
2317,!*%(@$%!,,gm101,1.88,31,-10,21
2316,That other one2.,,gm101,1.42,120,-31,89
2315,Dont Fail,,gm101,1.33,79,-38,41
2314,kite,,anton_s,2.10,30,-4,26
2313,snape,,anton_s,1.89,23,-5,18
2312,That other one.,,gm101,2.61,15,0,15
2311,The Puzzler,,gm101,1.73,38,-9,29
2310,Gm 101,,gm101,1.52,34,-22,12
2309,tubes,,anton_s,1.68,88,-5,83
2308,new time,,anton_s,2.08,26,-14,12
2307,Secret Room,,jaex,3.33,1,0,1
2306,Until Green,,jaex,3.17,3,-1,2
2305,Spaceship,,jaex,3.33,4,-1,3
2304,Hysteresis,,axorion,3.00,3,-1,2
2303,The green stared corners,,mcc900,2.81,18,0,18
2302,Simples,,jamiman,1.34,62,-28,34
2301,Relational Operators II,,qinn,4.60,4,0,4
2300,Crossbow,,axorion,3.60,2,-1,1
2299,Bit Count,,smylic,3.11,5,-2,3
2298,Taking Turns,,axorion,3.33,9,0,9
2297,Half Forward,,jaex,3.40,12,-1,11
2296,Jaexorion,,axorion,2.80,3,0,3
2295,96,,jaex,2.80,11,-2,9
2294,Square Growth + Spiral,,qinn,4.00,5,0,5
2293,cross the pinwheel,,onqt,1.76,80,-9,71
2292,2 Bit Way,,jaex,2.46,26,-1,25
2291,Rorschach,,axorion,3.57,8,0,8
2290,Antenna,,jaex,2.90,13,-1,12
2289,Star Flower,,jaex,2.63,9,-4,5
2288,Leonardo da Pisa,,axorion,3.40,5,0,5
2287,Big Wave,,jaex,3.25,4,-3,1
2286,Turning Blades,,jaex,3.25,3,-1,2
2285,Cinch III,,benjaminrr,2.94,19,-1,18
2284,Another Hammer,,qinn,2.95,14,-2,12
2283,Quicky,,butcher,1.41,132,-29,103
2282,If Green,,jaex,4.50,1,0,1
2281,Twice,,jaex,3.50,0,-1,-1
2280,MSB Plot,,axorion,2.80,5,0,5
2279,Addition and Subtraction,,qinn,3.83,5,0,5
2278,Cinch II,,qinn,3.29,14,-1,13
2277,Cinch ,,benjaminrr,2.78,32,0,32
2276,Store Length,,benjaminrr,3.17,18,0,18
2275,Recursive Flood Fill,,mortusnegati,3.17,5,0,5
2274,Giant Machine,,jaex,4.75,1,-2,-1
2273,Hip to Be Squared,,axorion,3.38,2,-3,-1
2272,Stack & Wrap Simplified,,axorion,3.25,8,0,8
2271,No right turn on red.,,espoire,1.95,34,-6,28
2270,The first time v2.0,,espoire,1.41,119,-25,94
2269,Spiral 5,,benjaminrr,3.14,12,-1,11
2268,Reflection II,,qinn,3.33,8,0,8
2267,Drunk Driver,,jaex,3.00,12,-2,10
2266,Magic Wand,,jaex,2.61,22,-1,21
2265,Vortex,,jaex,2.17,16,-2,14
2264,Ninja Star,,jaex,2.87,13,-1,12
2263,Decreasing Squares,,qinn,3.36,12,0,12
2262,Hatched Triangle III,,qinn,4.00,3,0,3
2261,Possibilities,,jaex,3.20,4,-2,2
2260,Spiral 4,,benjaminrr,3.50,7,0,7
2259,The way back,,igoro,2.04,62,0,62
2258,Another Color Changer,,qinn,3.00,11,0,11
2257,UFO,,jaex,2.55,13,-2,11
2256,Stack and Turn 747,,kragx,1.70,64,-9,55
2254,Weapon,,jaex,4.33,1,-1,0
2253,Maze,,daivuk,1.45,76,-38,38
2252,Dimension,,jaex,2.18,25,-3,22
2251,Stack & Wrap,,axorion,3.17,5,0,5
2250,Bot Fodder,,axorion,3.38,4,0,4
2249,Mark Eleven,,axorion,3.11,8,-1,7
2248,Windows,,jaex,1.78,70,-4,66
2247,Top and bottom 3,,smylic,2.89,19,-2,17
2246,Top and Bottom 2,,smylic,2.55,14,-4,10
2245,Apple Pie,,emptyhead,3.40,3,-1,2
2244,Alien,,jaex,3.11,7,-3,4
2243,Blue Diamond,,qinn,3.50,3,-1,2
2242,Remember me!,,sonybiard,2.00,16,-6,10
2241,Waves,,jaex,2.33,31,-1,30
2240,Minima,,smylic,4.00,11,0,11
2238,Maxima,,smylic,3.83,12,0,12
2237,paint stack,,onqt,2.54,22,-2,20
2236,Another Learning Stack,,jaex,1.95,69,-10,59
2235,Nested Stacks,,qinn,3.62,13,0,13
2234,One Way,,axorion,4.00,2,-1,1
2233,Squares,,jaex,1.97,27,-3,24
2232,Sum More,,axorion,4.00,3,0,3
2231,Some Sums,,axorion,4.00,4,0,4
2230,Pacman Thingy,,pshah19,1.43,101,-16,85
2229,Stars,,jaex,3.25,2,-2,0
2228,Easy Painting,,jaex,1.82,46,-5,41
2227,Two Way,,jaex,2.92,13,0,13
2226,Emblem,,jaex,2.52,12,-6,6
2225,18,,jaex,2.26,14,-5,9
2224,Auto Pilot,,jaex,1.32,222,-63,159
2223,Easy Stack,,jaex,1.90,36,-7,29
2222,Fish,,jaex,1.77,26,-4,22
2221,Double Stack 2,,jaex,1.40,82,-29,53
2220,Pattern,,jaex,2.25,30,-1,29
2219,Amulet,,jaex,1.93,34,-9,25
2218,Snake,,jaex,1.37,157,-44,113
2217,Button,,jaex,1.42,126,-28,98
2216,Monster,,jaex,1.97,25,-10,15
2215,Garden,,jaex,2.29,22,-3,19
2214,Double Stack,,jaex,1.42,128,-34,94
2213,Coin,,jaex,2.11,15,-5,10
2212,Chess Knight III,,smylic,3.00,5,-1,4
2211,Despair,,axorion,3.09,10,0,10
2210,Division 3,,qinn,4.00,3,0,3
2209,Relational Operators,,qinn,3.63,8,0,8
2208,Number Sequence +1,,qinn,4.80,5,0,5
2207,Crawler's Bane,,axorion,3.57,4,0,4
2206,A Puzzle For Everyone,,axorion,3.29,4,-2,2
2205,Factorial,,keyon,3.20,8,0,8
2204,Fork in the Road II,,russcinramona,1.53,34,-18,16
2203,One Left Turn (cover),,smylic,2.82,5,-4,1
2202,One Left Turn,,axorion,2.65,34,0,34
2201,dark cross,,onqt,1.52,81,-15,66
2200,Mind the fork in the road,,russcinramona,1.47,65,-28,37
2199,Projection I,,bofh,4.00,5,0,5
2197,Hemivoid,,axorion,3.63,9,0,9
2196,Red Fence II,,qinn,4.75,4,0,4
2195,Red Fence,,qinn,4.40,7,0,7
2194,bend 2,,onqt,1.37,170,-51,119
2193,Pac Man,,bd4drummer,1.35,247,-51,196
2192,Spite,,axorion,4.40,4,-1,3
2191,Rubies & Emeralds,,axorion,4.00,4,0,4
2190,Jack Handle,,axorion,3.50,4,0,4
2189,Jacked Over,,axorion,3.86,5,0,5
2188,two star,,onqt,3.08,9,-1,8
2187,red line,,onqt,1.65,71,-8,63
2186,easy paint 2,,onqt,1.73,96,-7,89
2185,2 squares,,onqt,1.50,65,-13,52
2184,''U'' for unhackable,,onqt,2.37,23,-2,21
2183,easy paint,,onqt,2.15,38,-2,36
2182,1/3 Jacked Up,,axorion,2.88,25,-1,24
2181,right angle,,onqt,1.53,84,-14,70
2180,obtuse angle,,onqt,1.35,147,-51,96
2179,acute angle,,onqt,1.90,56,-3,53
2178,All Jacked Up,,axorion,3.00,10,0,10
2177,SpirAlgebra II,,sticky,3.67,6,0,6
2176,One more spiral,,smylic,3.25,11,0,11
2175,Dizzy Director Zero (a visual aid),,axorion,3.63,5,-1,4
2174,Dizzy Director 2,,axorion,3.57,5,0,5
2173,Jabberwocky,,axorion,3.13,6,0,6
2172,easy,,charlon,1.31,383,-81,302
2171,3 holes,,onqt,2.33,36,-1,35
2170,Lorem Ipsum,,sticky,2.81,24,-1,23
2169,Spring 3,,keba,3.80,7,0,7
2168,Spring 2,,keba,3.12,25,0,25
2167,Bitshift,,ebusiness,3.00,16,0,16
2166,Hatched Triangle II,,qinn,3.25,4,0,4
2165,Hatched Triangle,,qinn,3.43,7,0,7
2164,Adding fuel to fire,,vincent,5.00,3,0,3
2163,Space Oddity,,kraker,3.20,3,0,3
2162,The Blues,,kraker,3.80,2,-1,1
2161,"turn,turn,turn",,onqt,1.57,102,-12,90
2160,the middle man,,onqt,2.06,19,-7,12
2159,Triple Stack,,kraker,3.14,4,-1,3
2158,Butterflies CAN be irritating...,,efilipponi,1.73,38,-7,31
2157,Negabinary substraction,,smylic,5.00,0,0,0
2156,Negabinary addition,,smylic,5.00,2,0,2
2155,Mark & Double,,axorion,3.20,2,-1,1
2154,Math Logistics 2,,axorion,3.11,4,0,4
2153,Belarus,,smylic,2.64,16,-6,10
2152,Drunken painter,,ebusiness,2.94,18,0,18
2151,Unhackable,,ebusiness,3.88,12,0,12
2150,Negabinary spiral,,smylic,3.43,5,-2,3
2149,Negabinary notation,,smylic,3.75,8,-1,7
2148,Math Logistics,,axorion,3.10,8,0,8
2147,Intricate math IV,,smylic,4.00,5,0,5
2146,Double back on red,,ebusiness,3.25,13,0,13
2145,Intricate math III,,smylic,4.50,4,0,4
2144,Border Dance 2,,axorion,3.00,4,0,4
2143,Border Dance 1.1,,axorion,3.00,9,0,9
2142,Border Dance,,axorion,3.00,9,0,9
2141,Bits of Wisdom,,axorion,3.71,8,0,8
2140,Factors,,keba,3.11,7,0,7
2139,L,,ebusiness,2.30,41,-1,40
2138,Simple Math 4,,axorion,3.06,18,0,18
2137,Intricate math II,,smylic,3.14,6,0,6
2136,Intricate math,,smylic,3.71,6,0,6
2135,Fibonacci addition,,keba,5.00,4,0,4
2134,woah,,timotheeee,2.67,16,-6,10
2133,Fibonacci notation II (v2),,smylic,4.00,3,0,3
2132,Stack Overflow,,axorion,3.38,13,0,13
2131,Simple Math 3,,keba,4.00,9,0,9
2130,Fibonacci and unary addition,,smylic,5.00,4,0,4
2129,Average Adversity II,,qinn,3.67,4,0,4
2128,Simple Math 2,,axorion,2.88,17,0,17
2127,Fibonacci substraction,,smylic,4.67,3,0,3
2126,Average Adversity,,qinn,4.00,5,0,5
2125,Fibonacci notation II,,smylic,3.33,5,0,5
2124,Fibonacci notation,,smylic,4.00,4,0,4
2123,Spin¬®alo,,ebusiness,3.83,5,0,5
2122,super stack (fixed),,onqt,1.79,42,-14,28
2121,Simple Math,,axorion,3.17,13,0,13
2120,GCD II,,smylic,4.00,2,0,2
2119,GCD,,smylic,2.50,4,-1,3
2118,Rutgers,,derekd,1.51,50,-28,22
2116,red river,,onqt,1.69,66,-25,41
2115,falling....,,onqt,1.98,47,-7,40
2114,Tessellation,,vincent,4.40,4,0,4
2113,Half Square,,keba,3.80,6,0,6
2112,Honest square II,,keba,4.00,6,0,6
2111,rainbow,,timotheeee,4.20,2,-2,0
2110,Honest square plus one,,keba,4.33,7,0,7
2109,Honest square,,smylic,4.00,3,-1,2
2108,(A+B) √∑ 2 = ,,benjaminrr,3.25,8,0,8
2107,Delay tutorial,,kraker,2.05,28,-1,27
2106,Van Gogh's Ear,,axorion,4.00,0,-1,-1
2105,7th column,,benjaminrr,3.25,3,0,3
2104,trick,,onqt,1.84,59,-5,54
2103,Van Gogh,,kraker,2.64,24,-2,22
2102,Quicky,,axorion,3.14,3,-1,2
2101,Waiting for Godot,,kraker,3.25,0,-1,-1
2100,What Should I Name This Puzzle?,,benjaminrr,3.67,1,-1,0
2099,Omission ?,,kraker,2.39,28,0,28
2098,Symmetry - Increasing Squares,,qinn,4.75,3,0,3
2097,Arms,,sticky,3.50,11,0,11
2096,Stack and Look III,,keith,3.36,8,-1,7
2095,Frame 1,,kraker,2.69,10,0,10
2094,Stack and Look II,,keith,2.57,23,0,23
2093,the spiral,,onqt,3.07,14,-2,12
2092,locked II,,onqt,2.17,27,-2,25
2091,locked I,,onqt,1.78,65,-5,60
2090,petty...,,onqt,1.73,40,-15,25
2089,Add,,thorinbur,2.92,12,-2,10
2088,??,,sherashia9,1.41,76,-29,47
2087,Complicated common puzzle,,smylic,3.60,4,-1,3
2086,Blind Alleys 2: Temporary blindness.,,axorion,3.75,4,0,4
2085,Formula,,sticky,2.83,7,0,7
2084,Blind Alleys,,axorion,3.50,5,0,5
2083,Triangle towers II,,ebusiness,3.45,13,0,13
2082,Stack and Look I,,keith,2.95,20,0,20
2081,Danglers,,axorion,4.00,5,-2,3
2080,One Dozen Dead Ends,,axorion,3.43,3,0,3
2079,123 III,,kraker,3.11,5,-1,4
2077,Fingers & Toes,,axorion,4.38,5,-1,4
2076,spoted,,onqt,1.75,36,-10,26
2075,Block Head,,antonbootsma,1.56,104,-25,79
2074,Decoration,,kraker,3.11,5,0,5
2073,123 II,,kraker,2.82,5,-3,2
2072,Resume,,sticky,2.82,14,0,14
2071,one,,onqt,2.24,26,0,26
2070,Correct measure,,ebusiness,3.07,21,0,21
2069,Take seven,,kraker,2.65,17,0,17
2068,Take five,,kraker,1.94,48,-5,43
2067,Stack & Stack,,kraker,3.11,9,-1,8
2066,Stack & Hack,,kraker,3.11,7,-1,6
2065,Follow Directions III,,qinn,3.25,8,0,8
2064,redy,,onqt,1.93,31,-8,23
2063,57,,bert,1.89,43,-5,38
2062,Back in reverse,,seranpol,1.31,404,-78,326
2061,Shrink Your Spirals,,benjaminrr,3.67,5,0,5
2060,No difference whatsoever (I),,kraker,3.38,6,-1,5
2059,Grimson's Lock,,benjaminrr,3.14,6,-1,5
2058,Neighborhood,,benjaminrr,3.50,10,0,10
2057,Bug run,,antonbootsma,1.34,289,-53,236
2056,Increasing Squares,,qinn,3.69,14,0,14
2055,Coelacanth,,kraker,4.00,1,0,1
2054,2 Spirals,,qinn,3.63,8,0,8
2053,Glitches in Programming,,masterluk,3.56,17,0,17
2051,Neighbors,,benjaminrr,3.31,14,0,14
2050,Rogue,,benjaminrr,3.50,10,0,10
2049,Wide spiral,,kraker,3.00,17,-2,15
2048,The volcano,,zerrat,3.00,7,-1,6
2046,Opposite Ends 2,,axorion,3.56,10,0,10
2045,Opposite Ends,,axorion,3.10,9,0,9
2044,Glic Eochair,,benjaminrr,3.43,17,0,17
2043,Chaos Theory,,masterluk,4.25,1,-2,-1
2042,Small differences matter II (improved),,kraker,3.40,2,0,2
2041,Less Than Obvious,,axorion,3.11,8,0,8
2040,padlock,,onqt,1.40,149,-61,88
2039,Subtleties,,axorion,3.57,4,0,4
2038,Small differences matter II,,kraker,1.44,44,-32,12
2035,Small differences matter,,kraker,3.83,3,0,3
2034,Flight through the void,,vincent,2.92,27,0,27
2033,The one outside,,vincent,2.74,23,-4,19
2031,alien,,mike239x,2.75,15,-4,11
2030,Copycat - Improved Version,,masterluk,3.13,14,0,14
2029,Copycat ,,masterluk,2.83,17,-1,16
2028,Value Trend,,masterluk,3.50,1,-1,0
2027,Discontinuation,,masterluk,2.48,21,-2,19
2026,color code,,onqt,1.50,228,-15,213
2025,Clear Track,,masterluk,4.60,2,-1,1
2024,Wrecked Tangles 2,,axorion,4.25,4,0,4
2023,flower,,mike239x,2.09,25,-5,20
2022,Fixtures,,masterluk,3.05,16,-4,12
2021,Wrecked Tangles 1.1,,axorion,3.27,9,0,9
2018,Street Light,,olga,2.68,14,-3,11
2017,Spiral 3,,benjaminrr,2.91,21,0,21
2016,Spiral 2,,benjaminrr,3.08,26,0,26
2015,Spiral,,benjaminrr,2.76,21,-1,20
2014,Sound Wave,,benjaminrr,3.00,14,-3,11
2013,Wrecked Tangles,,axorion,2.53,16,-1,15
2012,Travel the Four Corners of the Galaxy,,benjaminrr,3.17,8,-2,6
2011,Conditional Fiction (the starless color),,axorion,2.91,9,0,9
2010,Insignia (Specialist),,axorion,3.20,4,0,4
2009,Island,,ebusiness,3.00,8,-5,3
2008,Comb for trendy haircuts,,kraker,2.64,23,0,23
2007,Square Algorithme,,kraker,4.11,11,0,11
2006,Skate,,kraker,2.33,22,-4,18
2005,just a spiral,,onqt,2.10,44,-1,43
2004,To the hoop,,bigevildan,2.52,25,-2,23
2003,Islands,,ebusiness,2.27,35,-5,30
2002,Dragon curve meets knight,,ebusiness,3.00,8,-1,7
2000,assymetric cross,,mfosby,3.00,6,-3,3
1999,3X,,axorion,2.76,30,-1,29
1998,Modulus,,sticky,3.36,11,0,11
1997,Dragon curve - paint,,ebusiness,4.00,4,0,4
1996,Dragon curve,,ebusiness,3.20,5,0,5
1995,Curved Pitch Line,,benjaminrr,3.06,17,-1,16
1994,Blissful Ignorance v1.1,,axorion,3.00,7,-1,6
1993,Blissful Ignorance ,,axorion,2.64,15,-1,14
1992,big square,,onqt,2.71,26,-2,24
1991,Count to 0,,ebusiness,3.00,13,0,13
1990,Count to 3,,ebusiness,2.65,23,0,23
1989,the norwegian blue,,mfosby,4.00,3,0,3
1988,Simple paint spiral,,ebusiness,2.59,19,-1,18
1987,get 5 stars,,mfosby,1.91,34,-7,27
1986,silly goofing around,,mfosby,3.00,5,-4,1
1985,find the oasis,,mfosby,1.86,37,-12,25
1984,escaping the cave,,mfosby,2.85,17,-3,14
1983,Turnif - hard edition,,ebusiness,2.52,31,-1,30
1982,Turnif,,ebusiness,2.38,30,0,30
1981,Green day,,ebusiness,2.50,22,-2,20
1980,Dizzy Director,,axorion,3.43,4,0,4
1979,Tweakless,,axorion,3.45,9,-1,8
1978,Blue Corona,,axorion,5.00,0,0,0
1977,Triquarter,,axorion,3.50,12,0,12
1976,Easy Teasy,,kraker,3.67,3,-3,0
1975,After & Before,,kraker,3.50,12,-1,11
1974,Whatever,,benjaminrr,2.69,7,-4,3
1973,Insignia ,,axorion,3.75,4,0,4
1972,Flower,,benjaminrr,3.14,14,-1,13
1971,Flower,,siezer,2.08,62,-1,61
1970,New York,,benjaminrr,4.50,4,-1,3
1969,Conditions,,benjaminrr,3.50,1,-1,0
1968,Baby Dragon,,benjaminrr,1.30,51,-46,5
1967,Sticks and Stones won't break my Bones,,benjaminrr,3.17,8,0,8
1966,"Add, Subtract, Divide, or Multiply?",,benjaminrr,2.79,15,-2,13
1965,Linear Trend,,axorion,3.50,6,0,6
1964,haha,,pedrorz,1.53,76,-23,53
1963,smile,,amccampos,1.81,30,-13,17
1962,A tree's journey into Fall,,benjaminrr,2.54,27,-2,25
1961,Obviating Obfuscations,,axorion,2.89,18,-1,17
1960,All the way down,,kraker,2.72,19,0,19
1959,288,,sffallen,2.40,12,-2,10
1958,XXX,,sffallen,3.09,8,0,8
1957,Definitely Tetris,,sffallen,2.58,19,-1,18
1956,Still a simple cross,,sffallen,2.64,31,-1,30
1955,Eight Ball,,axorion,3.50,6,0,6
1954,Curses! Again!,,sffallen,2.41,24,-2,22
1953,MOth,,sffallen,2.71,16,-1,15
1952,Mixed Messages,,mattrulz127,?,0,0,0
1951,Flip Flop Flap,,sffallen,3.00,4,-2,2
1950,Lancelot,,sffallen,4.50,0,-1,-1
1949,Padlock,,axorion,3.67,5,-1,4
1948,Wind-up color swap 2,,mattrulz127,3.57,5,-1,4
1946,Pull The Trigger,,axorion,3.80,2,-1,1
1945,Cheap Bong,,axorion,3.08,12,-1,11
1944,Hookah II,,axorion,3.40,4,0,4
1943,SpirAlgebra,,sticky,3.38,11,0,11
1942,Quantum Quintet,,axorion,4.00,5,0,5
1941,Crescent ,,axorion,3.00,9,0,9
1940,Classic Stacker,,axorion,2.92,14,0,14
1939,Tricycle,,axorion,4.00,2,0,2
1938,Yoyo,,axorion,3.67,6,0,6
1937,Prediction Count,,axorion,3.33,9,0,9
1936,Rosetta Stone,,axorion,3.14,7,-2,5
1935,Quadrupling,,kraker,2.86,23,0,23
1934,Not easy2,,nima_,2.48,22,-3,19
1933,Not easy,,nima_,3.00,15,0,15
1932,Knightmare,,axorion,3.25,7,-2,5
1931,The Matrix,,axorion,3.13,5,0,5
1930,Morpheus,,axorion,2.10,12,-15,-3
1928,Hookah,,axorion,4.60,4,0,4
1927,No Smoking,,sticky,3.83,5,0,5
1926,block,,ianjulie,1.29,49,-35,14
1925,This is no cigarette ,,kraker,3.56,6,-1,5
1924,This is not a pipe,,kraker,3.57,6,-1,5
1923,A Dozen Sandbags,,axorion,3.00,11,0,11
1922,cross,,onqt,1.68,74,-10,64
1921,It takes two to tango (2),,kraker,3.00,18,0,18
1920,Geometric Transformations,,axorion,4.00,1,0,1
1919,Torque,,dvorjakque,2.09,34,-6,28
1918,Signal To Noise,,axorion,3.43,7,0,7
1916,spy 3,,onqt,2.00,28,-4,24
1915,spy 2,,onqt,1.74,67,-8,59
1914,NOW and LATER,,axorion,3.33,11,-1,10
1913,Uneven Step,,hisxlnc,2.11,27,-3,24
1911,spy,,onqt,1.59,67,-12,55
1909,"First Case, Second Case Part2",,sungjin,2.90,9,-1,8
1908,Nice Trip,,pipll,2.67,10,-4,6
1907,Binary Spiral,,chief,3.58,9,0,9
1906,Stack Toy,,axorion,3.50,13,0,13
1905,Red bridges,,sungjin,3.10,4,-4,0
1904,Where the turn?,,lendesg,2.83,14,0,14
1902,Spotted!,,sungjin,2.20,16,-3,13
1901,Huh? Part 5,,sungjin,3.14,12,0,12
1900,Huh? Part 4,,sungjin,1.90,41,-5,36
1899,Futility,,axorion,4.67,1,-1,0
1898,Over The Hills and Far Away,,super_flautist,1.75,41,-18,23
1897,Surf the web,,pulver,3.00,11,-1,10
1896,Big Firework ,,sungjin,2.68,20,-1,19
1895,Huh? Part3,,sungjin,1.58,93,-13,80
1894,Going into the Box,,sungjin,3.13,8,-1,7
1893,2010,,sungjin,1.55,48,-26,22
1892,Alligator,,sungjin,2.35,17,-5,12
1891,Simple Painting Q [Smaller],,sungjin,3.00,8,-2,6
1890,Growing Part2,,sungjin,2.53,12,-2,10
1889,Growing[Easy],,sungjin,1.30,683,-79,604
1888,Simple Painting Q,,sungjin,1.49,99,-17,82
1887,"First Case, Second Case",,sungjin,3.60,0,-4,-4
1886,Number 9,,kraker,3.13,7,-1,6
1885,Near Miss,,axorion,3.18,18,0,18
1884,bend,,onqt,1.36,175,-46,129
1883,pretzel twist,,jfm11,1.39,249,-34,215
1882,Delayed stack,,kraker,3.06,20,0,20
1881,Crawl away,,engraved,3.00,8,-1,7
1880,Star,,lendesg,2.30,16,-8,8
1878,It takes two to tango,,kraker,3.13,13,-2,11
1877,Two stacks,,lendesg,2.35,27,0,27
1876,Algorithme for Logarithme,,kraker,3.57,13,-1,12
1875,Skinning Cats,,axorion,3.08,11,0,11
1874,Tree of Balance,,masterluk,?,0,0,0
1873,Illogical Consequence,,masterluk,2.95,14,-1,13
1872,Overlapping Spiral,,axorion,3.30,9,0,9
1871,Half Rounded,,axorion,4.00,4,0,4
1870,Double your count...,,lendesg,2.31,24,0,24
1869,Get there,,bert,2.06,35,-8,27
1868,Dasic Dwesome,,tebo,2.78,11,-2,9
1867,Symmetry :) 9 fixed version,,lendesg,2.94,13,-1,12
1866,super stack,,onqt,1.51,125,-19,106
1865,Symmetry :) 9,,lendesg,1.79,45,-19,26
1864,Symmetry :) 8,,lendesg,4.75,1,-1,0
1863,bog!,,onqt,1.43,157,-23,134
1862,Asterix' knife,,kraker,2.85,13,-1,12
1861,Chiffre,,kraker,2.14,29,-3,26
1860,Starry pipe,,bert,3.22,5,0,5
1859,Code Green,,masterluk,3.13,16,0,16
1858,Two Step Switchblade,,bert,3.29,4,-2,2
1857,Double duty,,bert,2.93,15,0,15
1856,Spring,,bert,1.94,36,-5,31
1855,Ignorance,,sticky,3.27,9,0,9
1854,Symmetry :) 7,,lendesg,3.06,15,0,15
1853,Symmetry :) 6,,lendesg,2.42,32,-2,30
1852,Symmetry :) 5,,lendesg,3.07,12,-1,11
1851,Symmetry :) 4,,lendesg,3.11,22,0,22
1850,Symmetry :) 3,,lendesg,2.21,20,-8,12
1849,Symmetry :) 2,,lendesg,3.00,21,0,21
1848,Symmetry :),,lendesg,2.98,49,0,49
1847,MG2G Revisited,,axorion,3.33,10,0,10
1846,Scaffold Elevation,,masterluk,3.60,4,-1,3
1845,Sum,,kraker,3.10,10,-1,9
1844,Snake,,flyingdutchman,1.78,85,-5,80
1843,Code Blue,,masterluk,2.94,16,-1,15
1842,Double Flip Flop I (Retry),,sticky,3.07,14,0,14
1841,Double Flip Flop II,,sticky,3.15,14,0,14
1840,Double Flip Flop I,,sticky,2.71,9,-1,8
1839,Axorion's Axiom,,axorion,3.45,10,0,10
1838,Jump,,masterluk,2.49,30,-2,28
1835,Suck the colors,,theboomroasted,2.24,25,-5,20
1834,Gypsy,,recoveringhobo,2.11,24,-7,17
1833,bleh,,notofroto,1.32,277,-49,228
1831,Round and round and round and round and,,the_gza,2.08,32,-5,27
1829,USA Flag,,jfm11,1.96,23,-18,5
1828,Randomness,,skull5001,2.77,17,-2,15
1827,Sportz,,the_rza,1.32,294,-64,230
1826,the prince of bel air,,milksteak,1.44,151,-24,127
1825,flower,,jfm11,1.32,361,-69,292
1822,UberSpiral,,markus,1.39,194,-70,124
1819,hypnosis,,jfm11,1.37,222,-51,171
1818,diamond,,jfm11,2.69,11,-2,9
1817,Uzi 3,,lendesg,3.00,10,-1,9
1816,Uzi 2,,lendesg,1.68,51,-21,30
1815,Uzi,,lendesg,2.12,25,-4,21
1814,Simple Patterns,,axorion,3.75,8,-1,7
1813,Goat Milk,,justchillin,2.87,11,-1,10
1812,eat the spiral,,theboomroasted,1.71,62,-13,49
1811,Rainbow,,recoveringhobo,1.81,40,-7,33
1810,Easy as pie,,scarface,1.32,479,-99,380
1808,Leaping Limbo,,axorion,4.33,0,0,0
1807,the O,,jfm11,1.40,132,-46,86
1806,up & over,,onqt,2.09,33,-1,32
1805,Pattern Recognition,,axorion,3.75,3,-1,2
1804,Misleading Path,,justchillin,1.71,73,-12,61
1802,stairs,,lendesg,2.78,14,-2,12
1801,Maybe the colors don't matter? 4,,lendesg,1.72,43,-31,12
1800,Not obvious!,,d0td0td0t,4.00,1,-2,-1
1799,There is no way...?,,seegurke,3.07,8,-5,3
1798,Not too easy...IMHO,,d0td0td0t,3.15,8,-3,5
1796,Dance Floor,,masterluk,3.31,7,-1,6
1794,Colorand Road,,masterluk,3.00,7,-4,3
1792,Maybe the colors don't matter? 2,,lendesg,2.12,33,-2,31
1791,Code Red,,masterluk,2.29,16,-3,13
1790,Direction Deception - Turning Point,,masterluk,2.85,10,-2,8
1789,Find the corners,,lendesg,2.88,15,-1,14
1788,Triple or double your count?,,lendesg,2.24,7,-8,-1
1787,Find the way to the stars,,lendesg,3.00,8,-1,7
1786,Isolation,,tartanwolf,1.52,72,-25,47
1785,Underlined,,kraker,4.00,10,0,10
1784,Logarithmic graph,,kraker,4.78,8,-1,7
1783,Sieve,,axorion,3.60,3,-1,2
1782,wiggle,,onqt,2.48,16,-6,10
1781,More easy puzzle,,lendesg,2.08,28,-5,23
1780,Counting,,lendesg,2.96,22,0,22
1779,When to turn?,,lendesg,2.76,14,-2,12
1778,uht! uht! uht!,,onqt,1.63,90,-10,80
1777,Maybe the colors don't matter?,,lendesg,2.62,13,-5,8
1776,big stairs,,onqt,1.50,72,-19,53
1775,Little tree,,lendesg,1.31,398,-102,296
1774,little red path,,onqt,1.41,106,-15,91
1773,Function-Command Relationship,,masterluk,2.03,25,-6,19
1772,spiral ...,,onqt,1.47,132,-21,111
1771,Learning count 10,,lendesg,1.91,42,-9,33
1770,Twist 3,,lendesg,2.15,9,-5,4
1769,Twist 4,,lendesg,2.20,10,-5,5
1768,Paint & Unpaint,,kraker,3.18,7,-1,6
1767,Triple your count,,lendesg,3.00,18,0,18
1766,Twist 2,,lendesg,3.00,13,0,13
1765,scoop,,onqt,2.88,15,-1,14
1764,red vs. blue 2,,onqt,1.95,28,-7,21
1763,Flip a flop,,kraker,2.82,14,-3,11
1762,red vs. blue,,onqt,1.80,62,-7,55
1761,Twist 1,,lendesg,2.52,18,-3,15
1760,Key hole,,mrmojorisin12,2.71,5,-4,1
1759,Twins 3,,lendesg,2.64,10,-3,7
1758,Twins 2,,lendesg,2.60,9,-4,5
1757,Twins 1,,lendesg,2.86,10,-1,9
1756,Twister,,dvorjakque,1.76,74,-5,69
1755,Optimized Sub Functions,,dvorjakque,1.72,41,-15,26
1754,Sub Functions,,dvorjakque,1.69,49,-25,24
1753,Gaps & Stitches,,kraker,4.00,1,-3,-2
1752,Christmas,,onqt,1.42,368,-40,328
1751,Heartbreak,,bot1,2.71,7,-3,4
1750,lego head,,onqt,1.44,93,-54,39
1749,recursion,,onqt,1.33,262,-104,158
1748,bumpy box 3,,onqt,1.41,147,-22,125
1747,bumpy box 2,,onqt,1.75,43,-14,29
1746,bumpy box,,onqt,1.33,412,-86,326
1745,Inversion,,masterluk,2.75,9,-3,6
1744,a,,holgosapiens,1.36,153,-61,92
1743,Learning stack 4,,lendesg,1.87,41,-18,23
1741,Learning count 8,,lendesg,2.70,17,-2,15
1740,Non Sequitur (Latin for nonsense),,axorion,3.25,6,-1,5
1739,Eighth Note Beat ,,masterluk,2.92,9,-2,7
1738,Green Cube,,masterluk,2.07,27,-8,19
1737,Learning count 7,,lendesg,2.65,19,-3,16
1736,Learning stack 3,,lendesg,1.82,104,-8,96
1734,Learning stack and count,,lendesg,1.93,33,-6,27
1733,Learning stack,,lendesg,1.95,77,-12,65
1732,Learning count 6,,lendesg,2.55,19,-2,17
1731,Learning count 5,,lendesg,2.68,19,-1,18
1730,More tree,,lendesg,1.31,405,-68,337
1729,Learning count 4,,lendesg,2.68,23,-1,22
1728,Learning count 3,,lendesg,1.72,40,-10,30
1727,Learning count 2,,lendesg,2.53,14,-2,12
1725,Simple tree,,lendesg,1.32,459,-68,391
1724,Tree,,lendesg,1.33,346,-49,297
1723,Direction Deception - Red Arrow,,masterluk,2.85,24,0,24
1722,Colorand,,masterluk,4.00,2,-1,1
1721,Confusing spiral,,kraker,2.82,10,-1,9
1720,9,,obay,1.43,130,-53,77
1719,Red Block Obstacle,,masterluk,3.06,9,-4,5
1718,Concept Clash,,masterluk,3.00,4,-3,1
1717,Snail,,lendesg,1.57,93,-18,75
1716,mark and sweep 2,,lendesg,1.45,117,-17,100
1715,Shurikan Showdown,,masterluk,1.37,208,-32,176
1714,Boxy,,obay,1.36,237,-29,208
1713,Relative Acceleration (Improved Version),,masterluk,3.43,4,0,4
1712,Relative acceleration,,masterluk,3.43,4,0,4
1711,find path,,lendesg,1.50,99,-18,81
1710,A Questionable Configuration,,masterluk,2.07,32,-4,28
1709,Learning count and reuse,,lendesg,3.13,4,-1,3
1708,You can't beat the Pi,,lendesg,1.86,44,-8,36
1707,Lockmaze,,masterluk,2.81,8,-6,2
1706,Diving Fish,,kraker,3.00,15,-2,13
1705,Coverage,,masterluk,2.68,20,-2,18
1704,Mini Puzzle,,obay,1.42,211,-36,175
1702,mark and sweep,,lendesg,1.47,94,-16,78
1701,Tile set,,masterluk,1.90,15,-8,7
1700,Perilous Parities,,axorion,3.71,4,-1,3
1699,so easy,,lendesg,1.72,58,-22,36
1698,very easy,,lendesg,1.31,666,-143,523
1697,Just Left on red?,,lendesg,1.82,56,-5,51
1696,advanced spiral,,lendesg,1.89,22,-7,15
1695,easy,,joecryo,1.34,336,-42,294
1694,Wee!,,obay,1.43,134,-48,86
1693,Top and Bottom,,seanseansean,1.78,52,-14,38
1691,Functionality,,masterluk,3.00,13,-2,11
1690,Noose,,kraker,2.23,35,-1,34
1689,Bridge finder 2,,onqt,1.80,60,-7,53
1688,Red Falcon,,masterluk,2.52,26,-4,22
1687,Beyond 1000 steps (2),,kraker,3.00,2,0,2
1684,Left Turn,,sticky,3.04,23,0,23
1683,Beyond 1000 steps,,kraker,3.50,2,0,2
1682,Exponential Growth,,kraker,3.15,14,-1,13
1681,Blaster,,masterluk,3.00,12,-1,11
1680,Under Construction,,kraker,3.14,12,-1,11
1679,Red gold,,twinkletose,3.00,14,-4,10
1678,"T for ""Time-consuming""",,masterluk,3.10,10,-1,9
1677,Another growing cross puzzle,,kraker,3.06,17,0,17
1676,Double Your Count,,benjaminrr,2.16,57,-2,55
1675,Red Marks the Spot,,masterluk,1.86,41,-9,32
1674,Trail,,benjaminrr,2.30,31,-2,29
1672,Stupid Maze!,,benjaminrr,3.33,4,-2,2
1671,Thing,,obay ,2.02,41,-3,38
1670,True PathFind,,kotyaga,3.18,9,-1,8
1668,Double cross,,kraker,3.17,5,-1,4
1667,Round we go,,obay,1.34,449,-51,398
1666,Harder,,obay,1.38,166,-35,131
1665,Easy,,obay,1.38,181,-50,131
1664,Undecisive,,kraker,3.71,6,-1,5
1663,Dizzy Distance,,sticky,3.07,17,0,17
1662,Ninja Star,,benjaminrr,2.26,16,-4,12
1661,PathFind,,kotyaga,1.43,89,-40,49
1660,Connect the dots,,benjaminrr,1.58,79,-27,52
1659,Bridges,,benjaminrr,2.90,17,-1,16
1658,Paint and Turn,,rafaelromao,2.00,51,-5,46
1657,Fixing the Circit Board,,benjaminrr,3.00,9,-1,8
1656,Green Shrooms,,benjaminrr,3.43,6,-1,5
1653,packed,,supercat765,3.25,1,0,1
1652,Oddities,,kraker,3.44,6,-2,4
1651,Spin on Red!,,mzxrules,2.71,21,0,21
1650,To skip or not to skip,,kraker,4.00,4,0,4
1648,Otherworldly Stack,,joshrl,1.45,131,-29,102
1647,Keep on turning,,kraker,2.73,16,0,16
1646,Your turn,,kraker,3.17,11,0,11
1645,No Rules,,captncraig,3.21,11,-1,10
1644,Fish-sticks,,b1mmer,2.26,31,-10,21
1643,A Knight's Codex,,axorion,2.53,32,-1,31
1642,A perfect square,,julien,2.59,8,-4,4
1641,Dying Tree,,ihvaquestion,4.00,3,-1,2
1640,the untrivial trivialities [fixed],,asiekierka,2.50,26,-2,24
1639,exhaustive search,,dikzak,2.63,21,-5,16
1637,A Harder Tree,,asiekierka,1.32,326,-91,235
1636,A tree,,asiekierka,1.32,332,-98,234
1635,7,,sticky,3.00,18,0,18
1634,"Hold me tight, love",,deewiant,1.71,75,-8,67
1633,Chromatic odd or even,,igoro,3.25,12,0,12
1632,Branches with ternary directions,,keba,3.75,4,0,4
1631,On to the Autobahn,,kraker,3.62,13,0,13
1630,Edition II,,sticky,3.38,9,0,9
1629,TNT,,gas777,2.20,38,-4,34
1627,Edition,,sticky,3.00,13,0,13
1626,Crooked Branches II,,keba,4.67,1,0,1
1623,Branches with directions,,igoro,3.62,15,0,15
1622,Shrinking tree,,igoro,3.67,10,0,10
1621,Never forget,,igoro,3.11,21,-1,20
1619,Shoot and Spin,,dannythorne,4.00,3,0,3
1618,very easy,,holgosapiens,2.59,32,-2,30
1617,Left on Invisible Green,,katy,2.96,27,0,27
1616,4 squares,,joro73,2.36,34,-5,29
1615,binomial coefficients,,flarghsnoofter,4.00,8,0,8
1614,oops,,paninmischa,2.02,42,-5,37
1613,Push and Paint,,dannythorne,3.00,17,0,17
1612,pushd,,dannythorne,2.67,24,0,24
1611,short Levy C is short,,flarghsnoofter,4.60,4,-1,3
1610,Pure Deceit,,axorion,3.40,4,-1,3
1608,Patched Fractal,,axorion,3.67,5,-1,4
1607,Crazy Christmas,,axorion,3.25,10,0,10
1606,the lady or the tiger,,flarghsnoofter,2.39,34,-1,33
1605,Rule 18,,dannythorne,3.83,5,-2,3
1604,Fibonacci Spiral Again,,dannythorne,3.10,6,-3,3
1603,zig-zag,,abhinav_10,1.50,108,-58,50
1602,Pseudosymmetric,,axorion,3.54,16,0,16
1600,Fractagon 24,,axorion,3.40,9,0,9
1599,The Mask,,axorion,3.60,4,0,4
1598,Endless Tree,,keba,3.50,7,0,7
1597,route to yhe top,,samarth,2.02,35,-14,21
1596,Forgot one,,kraker,1.62,86,-17,69
1595,layers 2,,samarth,1.75,81,-27,54
1594,layers,,samarth,1.71,77,-24,53
1593,Follow Path,,roboz,1.46,147,-51,96
1592,along the margin,,samarth,2.42,36,-1,35
1591,asymmetry,,samarth,2.21,26,-2,24
1590,tank,,samarth,3.21,13,0,13
1589,cyclops,,samarth,3.63,4,-2,2
1588,Crooked Branches,,keba,3.63,9,0,9
1587,Symmetry - Color Turn,,keba,4.20,5,0,5
1586,Switching Sides,,snydej,3.16,20,0,20
1585,Dizziness II,,keba,3.67,4,0,4
1584,Enchanted Path,,acid50150,5.00,0,0,0
1583,Color Turn,,snydej,2.93,11,0,11
1582,Endless Belt (lite),,kraker,3.00,13,0,13
1581,Yet Another Tree,,snydej,3.17,21,0,21
1580,red dashes,,samarth,2.26,36,-4,32
1579,square,,samarth,1.58,99,-11,88
1578,another spiral,,samarth,1.77,80,-10,70
1577,Passing The Buck,,axorion,3.45,10,0,10
1576,Branches on green,,gagguy,1.46,125,-36,89
1575,Branches on green? Again,,gagguy,1.43,115,-37,78
1574,Branches on green?,,gagguy,2.69,28,-2,26
1572,Impertinent Datum III,,axorion,3.29,13,-1,12
1571,Sweep & Crawl,,kraker,2.68,30,0,30
1570,Sweep & Stack,,kraker,3.50,1,-1,0
1569,Impertinent Datum (Butterfly),,axorion,2.88,17,0,17
1568,Simple Crawl,,caled,3.11,19,0,19
1567,battery,,samarth,1.38,189,-44,145
1566,Randomize 2,,zymanch,2.87,9,-2,7
1565,Concave Squid,,caled,1.62,74,-31,43
1564,Impertinent Datum II,,axorion,2.79,11,0,11
1563,Counting disharmony,,kraker,2.36,25,0,25
1562,Moat,,kraker,2.72,24,-1,23
1561,Weave II,,keba,2.48,25,-1,24
1560,Double Dutch,,axorion,1.87,66,-9,57
1559,Hopscotch,,axorion,2.41,30,-3,27
1558,Slightly different crawls,,kraker,3.29,4,-1,3
1556,Fractions,,caled,3.43,5,-2,3
1555,Three Phase,,axorion,3.13,16,0,16
1554,Happy :),,ddakev,1.40,167,-38,129
1553,Not square,,kraker,1.97,54,-6,48
1552,Another crawler,,kraker,3.15,13,0,13
1551,Hushpuppy,,kraker,2.94,18,0,18
1550,Stack & Crawl,,axorion,3.20,12,0,12
1549,Endless Belt,,kraker,4.25,1,-1,0
1548,Wiggle & Crawl,,kraker,2.41,53,0,53
1547,choose a color,,blackadder,2.37,12,-6,6
1546,Sandbox,,axorion,4.44,3,-2,1
1545,Chromatic Convolution IV v1.1,,axorion,3.50,4,0,4
1544,Chromatic Convolution IV,,axorion,3.00,4,-3,1
1543,Chromatic Convolution III,,axorion,3.50,3,-2,1
1542,Interception,,kraker,2.52,24,0,24
1541,Regurgitated Leftovers,,keba,4.00,4,-1,3
1540,Chromatic Convolution II,,axorion,4.36,11,0,11
1539,arbitrary counting,,lcurtne,2.07,60,-4,56
1538,Chromatic Convolution,,axorion,2.87,25,-1,24
1537,Flic-flac,,kraker,2.79,13,0,13
1536,Right round,,fractalchez,2.73,21,-3,18
1535,Stale Leftovers,,axorion,3.80,5,0,5
1534,Cold Leftovers,,axorion,3.86,8,0,8
1533,test,,lcurtne,1.83,51,-22,29
1532,Leftovers,,axorion,3.83,6,0,6
1531,Fill Me II,,rako,3.69,7,-5,2
1530,Fill me,,rako,3.92,4,-7,-3
1529,Monochrome II,,axorion,2.90,22,0,22
1528,Y-goal,,orjan,1.98,27,-14,13
1527,Solitary Actuary,,axorion,3.07,15,0,15
1526,Flip-flop Maze (lite),,kraker,3.08,10,0,10
1524,More Recursive Precursions,,axorion,3.33,5,0,5
1523,Fractagon 20,,axorion,2.87,14,-1,13
1522,Picasso,,caled,3.22,4,-5,-1
1521,Lonliest star,,fractalchez,2.61,27,-2,25
1520,Red Rover,,axorion,3.75,4,0,4
1519,Meandering Margins,,axorion,3.10,24,0,24
1517,Randomize,,zymanch,2.05,65,-10,55
1516,Vertical Addressing (Octal Ops Light),,axorion,3.44,11,0,11
1515,o.O,,neotoby,1.88,51,-3,48
1514,Tiling II,,keba,2.23,23,-9,14
1513,Octal Operations,,axorion,3.25,4,-1,3
1512,Flip-flop Maze,,kraker,3.55,10,-1,9
1511,Combo Breaker,,snydej,3.35,24,0,24
1510,Multiplex,,sticky,3.45,10,0,10
1509,Coloured Stack (stubborn),,kraker,4.50,2,-2,0
1508,Coloured Stack (irritated),,kraker,3.05,14,0,14
1507,Dance me to the end of love,,fractalchez,3.33,7,-3,4
1506,Impertinent Datum,,axorion,3.60,10,0,10
1505,Turning Point 2,,riske,4.40,3,-2,1
1504,Coloured Stack (stirred),,kraker,2.44,29,-2,27
1503,Ant,,roboz,2.85,18,-6,12
1502,Coloured Stack,,kraker,1.73,58,-20,38
1501,Getting Flashier,,kraker,2.47,27,-3,24
1500,Get 1500,,termos,2.82,15,-3,12
1499,Expand Around,,servatron,1.85,46,-9,37
1498,0,,servatron,1.50,121,-89,32
1497,The Sixth Power,,axorion,2.96,27,-1,26
1496,Stars over Emeraldcity again,,termos,3.56,8,-3,5
1495,Stack & Plain (angry),,kraker,5.00,0,-1,-1
1494,The Seventh Power,,axorion,3.05,21,-1,20
1493,Shine of Emeraldcity,,termos,2.69,21,-1,20
1490,Catacombs,,termos,3.38,15,-1,14
1489,Growth Pattern,,servatron,2.21,25,-3,22
1488,Galaxy,,termos,3.06,20,-1,19
1487,Red vs Blue Alien,,servatron,2.89,5,-4,1
1486,L-Box,,servatron,2.43,13,-4,9
1485,Dog,,termos,1.73,80,-9,71
1484,Stars over Emeraldcity,,termos,2.94,11,-3,8
1483,Fractagon 28,,axorion,3.50,15,-1,14
1482,Red eyes,,termos,3.14,10,-2,8
1481,Axorion's Gambit,,axorion,4.25,5,0,5
1480,smile,,mike239x,2.45,27,-3,24
1479,Seven Of Nine,,axorion,4.00,1,-1,0
1478,How it burns,,caled,1.54,17,-14,3
1477,Rock Around the Clock,,serdel,2.02,49,-19,30
1476,Wheel Of Misfortune,,axorion,2.92,13,0,13
1475,JAP,,engraved,3.05,37,-1,36
1474,Fractagon 36,,axorion,3.11,17,-1,16
1473,Crazy hammered,,nevzor,3.50,7,-1,6
1472,Alternating Reds (Constrained),,sticky,3.25,7,0,7
1471,Decremental,,axorion,3.23,13,0,13
1470,Masochist's Delight,,axorion,4.00,1,0,1
1469,Incremental,,axorion,3.10,24,0,24
1468,Stack & Plain (stubborn),,kraker,2.59,37,-1,36
1467,Critical Mass,,axorion,3.38,5,-1,4
1466,Turning Point,,riske,4.60,3,-1,2
1465,Ends II,,sticky,2.92,24,0,24
1464,Counting Corners,,axorion,2.81,31,0,31
1463,Stack & Plain (irritated),,kraker,1.83,38,-19,19
1462,Stack & Plain (stirred),,kraker,1.90,41,-19,22
1461,Symmetry - Return,,sticky,3.70,11,0,11
1460,Stack & plain,,kraker,1.83,37,-18,19
1459,Twist,,termos,2.01,52,-15,37
1458,Forest and river,,termos,2.89,21,0,21
1457,Box,,termos,1.72,91,-21,70
1456,Air Plane,,servatron,3.44,8,-1,7
1455,Space racing,,termos,2.94,15,-2,13
1454,Ruins,,termos,2.02,40,-7,33
1453,Web,,termos,1.45,195,-50,145
1452,Symmetry - Evens and Odds,,sticky,3.75,7,0,7
1451,Simple Galaxy,,termos,2.37,29,-1,28
1450,Twice Passed Green Twice,,axorion,3.62,13,-2,11
1449,Not a Good Example,,servatron,4.67,1,-2,-1
1448,R2D2,,asdfing,2.03,47,-12,35
1447,Grid Lock,,servatron,1.44,183,-42,141
1446,Stairway to Robozzle,,servatron,1.84,43,-10,33
1445,1+1=10,,gudy,4.67,3,0,3
1444,Even Turn Fall Through,,axorion,3.17,5,-1,4
1443,Practically Possible,,axorion,3.29,6,0,6
1442,Saluting dancer,,kraker,2.47,32,-1,31
1441,Simple instructions VI,,mcfig,2.82,26,0,26
1440,Monolithic III,,axorion,2.51,40,-2,38
1439,Monolithic IV,,axorion,3.44,7,-2,5
1438,Tag reuse (lite),,kraker,2.69,28,-1,27
1437,Simple instructions V,,mcfig,2.19,20,-7,13
1435,Simple instructions IV,,mcfig,2.00,33,-29,4
1434,Monolithic I,,axorion,2.55,35,-2,33
1433,Simple Instructions III,,mcfig,1.57,145,-17,128
1432,Two stairs,,nevzor,1.88,45,-5,40
1431,hook,,nevzor,1.88,64,-5,59
1430,Changing angle,,nevzor,1.54,238,-19,219
1429,Monolithic II,,axorion,2.70,20,-3,17
1428,Tag reuse,,kraker,3.67,3,0,3
1427,Search the Checkerboard,,snydej,4.40,5,0,5
1426,Alternating Color Maze,,snydej,2.96,14,-3,11
1425,123,,kraker,3.25,8,0,8
1424,Easy algorithm,,pulver,3.08,23,-4,19
1423,what,,eben,1.50,224,-33,191
1422,Alternating Tree,,snydej,3.27,29,-1,28
1421,some,,jowsithm,1.59,133,-20,113
1420,Maze solver,,mcfig,1.64,108,-38,70
1419,Simple instructions II,,mcfig,2.44,22,-4,18
1418,Simple instructions,,mcfig,2.60,15,-4,11
1417,Two crosses,,mcfig,2.23,23,-5,18
1416,Red tile stabilizer,,kraker,3.00,21,0,21
1415,Checker Board,,firebirds,2.54,13,-3,10
1413,Barcode IV,,kraker,3.38,4,0,4
1412,Curvy,,kraker,2.22,43,-2,41
1411,Barcode I (Parody),,kraker,1.48,51,-34,17
1410,Barcode II ,,kraker,3.10,7,-1,6
1409,Phipes,,phipes,2.90,21,-3,18
1408,Burberry variety II,,kraker,2.25,26,-6,20
1407,Burberry variety I,,kraker,2.27,33,-4,29
1406,There is no I in Team!,,rweba,3.07,6,-3,3
1405,forwards and backwards,,penguinagent,1.98,32,-14,18
1404,easy,,penguinagent,1.74,118,-11,107
1403,Burberry,,kraker,2.17,26,-6,20
1402,i love to be easy,,matan7890,1.50,110,-95,15
1401,Ultra Symmetry,,sticky,3.43,9,0,9
1398,Cascade,,kraker,2.94,19,0,19
1397,Color me please,,pulver,2.95,12,-4,8
1395,Multipath,,eried,4.00,3,0,3
1394,Sonar Training,,sticky,3.55,9,0,9
1393,go!,,danies,1.77,73,-23,50
1392,61,,danies,1.54,92,-38,54
1391,UuUuUuUu,,danies,1.45,223,-37,186
1390,Sonar,,sticky,3.75,8,0,8
1389,Super Symmetry,,sticky,3.40,11,0,11
1388,Headlines I (tutorial),,kraker,2.93,16,-3,13
1387,Headlines II (interference),,kraker,3.00,10,-3,7
1386,Headlines III (ambiguity),,kraker,3.40,7,-3,4
1385,Headlines IV (paradox),,kraker,4.00,9,-2,7
1384,Headlines V (hint),,kraker,3.83,6,-2,4
1382,Routine Polyfunctionals,,axorion,3.13,7,-1,6
1381,Socrates,,philosopher,2.06,63,-3,60
1380,Lengthening Arms,,markbyers,3.13,9,0,9
1379,Wide Path,,snydej,3.62,9,0,9
1378,Symmetric Protrusions,,snydej,3.75,17,0,17
1377,Obstructions III,,snydej,3.17,23,0,23
1376,Step Memory,,snydej,3.18,17,0,17
1375,Spiraling Reuse,,axorion,4.25,2,-1,1
1374,Red Scare,,sint4x,2.61,10,-3,7
1373,Turning Red,,sticky,3.14,17,0,17
1372,Divorce,,kraker,2.32,27,-2,25
1371,Pentamonic Lamentations,,axorion,2.79,16,-10,6
1370,Dizzy,,dogsonofawolf,2.41,50,-6,44
1369,Lame Horse,,axorion,4.00,6,0,6
1368,Paintings Of Knights II,,axorion,4.60,2,-1,1
1367,Paintings Of Knights (Just for fun),,axorion,2.82,11,-1,10
1366,Two basic techniques needed,,kraker,2.95,27,0,27
1365,Alternating Colors,,sticky,3.57,15,-1,14
1364,Alternating Reds,,sticky,2.06,26,-18,8
1363,Windmills of your mind,,kraker,2.89,27,0,27
1362,Symmetry - Spiral Painting 2,,keba,3.75,9,0,9
1361,Blue submarine,,kraker,2.67,15,-1,14
1360,Precursive Spiral,,axorion,3.36,10,-1,9
1359,Steps,,mahaveer,3.10,20,-1,19
1358,Typo IV,,sticky,3.22,6,-1,5
1357,treesearch,,spliffen,2.96,24,0,24
1356,Chromatic Omissions,,axorion,3.11,5,-2,3
1354,Everysquare?,,zasknu,3.80,3,-2,1
1353,Chicken is not the name of this level,,cameron_adams,1.89,30,-10,20
1352,Elephant??,,cameron_adams,1.67,80,-35,45
1351,Basic Technique Rally (lite),,kraker,2.10,34,-5,29
1350,Basic Technique Rally,,kraker,2.86,18,-1,17
1349,Take all,,mahaveer,2.06,55,-7,48
1348,Missing green,,r0r0,3.00,5,-1,4
1347,Coilgun,,dogsonofawolf,2.25,57,-1,56
1345,Knight's Game I,,dogsonofawolf,1.52,161,-41,120
1344,There and Back Again,,dogsonofawolf,2.18,44,-7,37
1342,Cliffhanger,,4002483,2.94,16,-2,14
1341,1337,,konda,1.65,83,-35,48
1339,ooooooh,,konda,1.95,43,-19,24
1338,Do You Hate Me Yet?,,cameron_adams,1.48,183,-57,126
1337,Chia Face,,james_creek,5.00,1,-2,-1
1336,Tennis for One,,zasknu,2.23,37,-5,32
1335,My Brain Hurts,,cameron_adams,3.57,1,-4,-3
1334,Go back,,theoz,2.45,36,-1,35
1333,Almost a Face,,cameron_adams,2.48,17,-7,10
1332,Tetris1,,mexicanjewfro,1.32,376,-91,285
1331,Window into Abyss,,cameron_adams,3.50,4,-5,-1
1330,Painter's Tape,,cameron_adams,3.67,3,-3,0
1329,Das Simple.,,sint4x,1.63,25,-21,4
1327,8,,konda,1.36,228,-58,170
1326,Angular Recitation ,,axorion,2.94,18,-1,17
1322,China,,konda,1.34,147,-45,102
1320,Jr. Sandwich,,cameron_adams,2.64,23,-4,19
1319,Stars and Corn Dogs,,cameron_adams,2.75,1,-2,-1
1318,Blocks for Breakfast,,cameron_adams,2.42,38,-7,31
1317,Circuit,,mexicanjewfro,1.41,265,-92,173
1316,PCP,,sint4x,3.13,10,-2,8
1315,Eiffel Tower?,,sli_92,2.65,29,-1,28
1314,Double Back Light,,axorion,2.86,20,-1,19
1311,Paint the town red,,konda,1.45,200,-81,119
1308,Crazy Squares,,james_creek,4.11,8,-2,6
1307,Don't Turn on Blue,,zasknu,2.02,51,-6,45
1306,Grim,,cameron_adams,2.02,27,-12,15
1305,Ma comb,,2light,1.88,54,-19,35
1303,Tile,,cameron_adams,1.85,53,-22,31
1302,Spiral,,kbr22293,1.51,200,-33,167
1301,Flag,,cameron_adams,1.63,105,-19,86
1300,Just get'm all,,kraker,2.74,21,0,21
1299,Follow The Snakes (variation),,kraker,2.92,11,-1,10
1298,Think Ahead,,sint4x,2.11,38,-7,31
1297,Parity Backlash,,axorion,3.09,11,0,11
1296,Rewind Tape - Simplified,,countdown_0,3.11,18,0,18
1295,L0L,,konda,2.37,23,-4,19
1293,Ohm,,mexicanjewfro,1.56,29,-18,11
1292,MG2G,,axorion,3.13,7,0,7
1291,tight turning,,kbr22293,1.83,44,-24,20
1290,Paint ,,theoz,2.31,39,-3,36
1289,Switch,,lpeiros,1.72,42,-26,16
1288,Harp stacking,,style,2.44,49,-1,48
1287,Inhumanely Difficult,,axorion,5.00,1,0,1
1286,Order,,sticky,3.14,15,0,15
1285,Double Stack,,sticky,3.60,5,0,5
1284,Island Hopping,,axorion,3.00,11,-3,8
1283,Green Strayer,,foerno,2.88,24,-1,23
1282,Crocodile Tears,,dogsonofawolf,1.91,51,-14,37
1281,Color nightmare,,kfl_actua,3.00,6,-4,2
1280,Spliffenesque,,axorion,2.94,15,-1,14
1279,Hmm...maybe?,,spliffen,2.44,34,0,34
1278,Were are we going?,,antonbootsma,2.27,23,-6,17
1277,Steroids II,,axorion,3.27,13,0,13
1275,Steroids,,axorion,1.97,40,-28,12
1274,Monochrome,,axorion,3.46,11,-1,10
1269,Postage Stamp,,axorion,3.09,10,-1,9
1268,Double Back,,axorion,3.00,8,-1,7
1267,stars on the red 4,,beko,2.07,49,-14,35
1266,Stars on the red 3,,beko,1.31,174,-52,122
1265,Stars on red 2,,beko,1.35,498,-52,446
1264,Daniel puzzle 2,,damzero,2.53,34,-4,30
1262,Turn Timer,,axorion,4.25,1,-1,0
1261,stars on E (BEKO),,beko,1.41,213,-65,148
1258,;D,,beko,1.42,337,-66,271
1257,stars on the red,,beko,1.55,160,-26,134
1256,WoW,,beko,1.36,50,-36,14
1253,Typo III,,sticky,3.60,4,0,4
1252,Hmm,,beko,1.33,392,-88,304
1251,Big plus,,beko,1.65,197,-14,183
1247,Way Too Difficult,,axorion,5.00,0,0,0
1246,Turn&Recursion,,roboz,2.48,18,-4,14
1245,Simple Precursive Smear,,axorion,3.50,3,0,3
1244,Recurse&paint,,roboz,1.88,56,-23,33
1243,Chromatic Precursors III,,axorion,3.25,4,0,4
1242,Right Exit,,foerno,2.29,35,-4,31
1241,Where did the corners go?,,gram314,3.50,2,-3,-1
1240,Strange Turning Even Odder,,axorion,2.91,23,-1,22
1239,"left on green, right on red ;-)",,wallacoloo,2.97,23,-3,20
1238,Resonance 2,,evko,3.57,7,0,7
1237,Resonance 3,,evko,3.08,12,0,12
1236,Somewhat Wallhugging,,wallacoloo,3.07,31,0,31
1235,Only two drinks,,evko,1.44,213,-33,180
1234,Training Day III (hacking),,axorion,3.12,17,0,17
1233,"Nostalgia about ""Boulder Dash""",,evko,4.00,6,0,6
1232,Colored boxes,,evko,3.88,9,0,9
1231,Red Butterfly,,rafaelromao,2.69,26,-3,23
1230,A viewpoint on tree,,evko,3.70,11,0,11
1229,wutta stacking,,style,2.67,29,-3,26
1228,Wallhugger,,jespergravgaar,1.80,122,-26,96
1227,Stacking for not so newbies,,style,2.25,67,-3,64
1226,Tiling,,keba,3.38,7,-1,6
1222,d,,dzatara_pz,1.56,114,-34,80
1221,Training Day II (Monolithic) v1.1,,axorion,3.29,14,-2,12
1220,Synapses II,,sticky,3.08,11,0,11
1219,Training Day II (Monolithic),,axorion,2.50,19,-3,16
1218,random stacking,,style,2.49,33,-4,29
1217,Training Day I (3.25 laps),,axorion,2.46,42,-2,40
1216,Barbells (Heavy),,sticky,3.18,10,0,10
1215,read + turn,,timotheeee,3.09,20,-2,18
1214,Simple Recursive Precursion v1.1,,axorion,3.50,14,0,14
1212,Dark Night,,elegrem,2.32,28,-8,20
1211,Stacking for newbies,,style,2.02,122,-4,118
1210,Prezel,,style,1.82,123,-13,110
1209,Barbells,,sticky,3.06,17,0,17
1208,Post Chromatic Stress Disorder,,axorion,4.14,4,0,4
1207,Almost Symmetric 2,,rafaelromao,2.60,32,-2,30
1206,Patience III,,sticky,3.11,20,0,20
1205,Blue Squares,,kelntaylor,3.06,10,-5,5
1204,Chromatic Precursors II,,axorion,4.00,5,0,5
1203,One Function Challenge,,wallacoloo,3.08,23,-1,22
1202,Toaster,,mattrulz127,2.06,78,-8,70
1201,Synapses,,sticky,3.17,24,0,24
1200,Red...Five?,,mattrulz127,2.18,48,-4,44
1199,Resonance,,evko,2.84,44,0,44
1198,The hardest - 2,,borjusjka,4.50,2,-2,0
1197,Hardest of all,,borjusjka,3.25,2,-4,-2
1196,Smart Mover,,borjusjka,1.97,77,-8,69
1194,4 Corners,,vendrake,3.60,10,0,10
1193,Axorion's Hypocrisy,,axorion,4.00,2,0,2
1192,Confusion,,pietjepuk,2.86,1,-3,-2
1191,Saint John's Arms,,sticky,3.44,17,0,17
1190,Cursed and recursed,,mquander,1.59,147,-35,112
1189,Variable Crosses Lite,,keba,3.21,23,0,23
1188,Weave,,keba,3.50,3,0,3
1187,Red Continuation 3,,rafaelromao,2.28,16,-8,8
1186,2-Command Functions,,mattrulz127,1.77,98,-29,69
1185,Red Continuation 2,,rafaelromao,3.06,14,-2,12
1184,Get The Greens 3,,rafaelromao,2.19,44,-7,37
1183,Curly Tail,,keba,3.70,8,-2,6
1182,wild guess,,pietjepuk,2.16,61,-5,56
1181,Path of Darkness - Wiggle,,markbyers,4.14,5,-1,4
1180,Emerald Omission II,,axorion,2.96,23,-1,22
1179,left or right ?,,timotheeee,2.95,18,-2,16
1178,Four Greenbacks,,axorion,3.67,9,0,9
1177,Chromatic Precursors,,axorion,4.00,6,0,6
1176,Carnival Choice,,stitched_milo,4.14,2,-3,-1
1175,Testing1,,antonbootsma,1.91,71,-15,56
1174,Get The Greens 2,,rafaelromao,4.43,5,-3,2
1173,Let's Dance,,axorion,2.57,35,-3,32
1172,Code blue,,loaril,2.30,28,-10,18
1171,Bisect Or By Sector,,axorion,2.92,11,-1,10
1169,Ternary Path 1 M&M (v2),,keba,3.67,7,0,7
1168,Ternary Path 1 M&M,,keba,3.13,8,0,8
1167,Ternary Path 1 M,,keba,3.05,22,0,22
1166,Ternary Path 2,,keba,3.80,3,-1,2
1165,Ternary Path 1,,keba,1.72,113,-13,100
1164,Variable Crosses,,keba,4.71,5,-2,3
1163,cross swapping,,joebobfrank,2.94,13,-1,12
1162,er... left on blue? #2,,joebobfrank,2.18,33,-13,20
1161,Dangerous Path 2,,rafaelromao,1.51,210,-40,170
1159,er... left on blue?,,joebobfrank,2.24,36,-9,27
1158,Round he goes,,akfreak,1.41,351,-66,285
1157,Dangerous Path,,rafaelromao,4.00,0,-1,-1
1156,Emerald Omission,,axorion,3.05,19,-1,18
1155,Piers & Piers,,sticky,3.50,10,0,10
1154,Maelstrom Deliverance,,axorion,3.56,5,-3,2
1153,Not again,,ebusiness,3.75,8,0,8
1152,Typo II,,sticky,3.90,10,-1,9
1151,symmetry + paint 3,,timotheeee,3.06,15,0,15
1150,Typo,,sticky,3.77,11,0,11
1149,Patience II,,sticky,3.35,17,-2,15
1148,Too Trite,,keba,4.00,9,0,9
1147,Overlapping Crosses,,markbyers,2.57,49,0,49
1146,Green Herring,,smithcat,2.75,11,0,11
1145,finferad,,style,2.82,32,-1,31
1144,Prealgebra,,sticky,2.97,30,-1,29
1143,Patience,,sticky,3.00,36,0,36
1142,Starstack,,bananskuden,1.94,59,-14,45
1141,Uneven Handlebars,,bluntpencils,4.00,5,-1,4
1140,Subfunctions (deja vu),,beaza,2.11,41,-11,30
1139,Subfunctions (flip flop),,beaza,1.87,95,-10,85
1138,Paratangles,,sticky,2.57,33,-2,31
1137,Fibonacci,,ebusiness,3.78,7,0,7
1136,Stars on red tiles.,,rilo,3.11,19,-2,17
1135,One Side,,sticky,3.00,24,-1,23
1134,Thairai,,style,1.78,97,-12,85
1133,Skippy,,rilo,2.68,30,-2,28
1132,Steer,,bluntpencils,3.80,3,-1,2
1131,2 bit binary path,,keba,3.50,7,0,7
1130,simple as whitefish,,style,2.64,18,-5,13
1129,(A and B) or (C and D),,beaza,3.87,16,0,16
1128,(A xor B),,beaza,3.04,26,0,26
1127,(A and B and C),,beaza,2.91,27,0,27
1126,(A or B or C),,beaza,3.04,27,0,27
1124,twirtel,,style,2.81,30,0,30
1122,Parameter,,ebusiness,3.00,22,-1,21
1120,The Bug,,style,2.04,51,-8,43
1119,Siika Da Kala ^7,,style,1.63,173,-41,132
1118,siika da WtF,,kabah,1.35,499,-102,397
1116,siika da FuUU,,kabah,1.46,334,-112,222
1115,siika da :O,,kabah,1.71,121,-20,101
1114,siika da emt,,kabah,1.72,95,-21,74
1113,siika da da siika,,kabah,1.70,94,-17,77
1112,Siika Da Kala ^6,,style,1.73,101,-25,76
1111,siika da siika,,kabah,1.73,101,-28,73
1110,Siika Da Kala ^5,,style,1.36,472,-93,379
1109,siika da kabah,,kabah,2.07,55,-15,40
1108,siika da kala ^4,,style,1.73,138,-18,120
1107,da siika,,kabah,1.74,108,-13,95
1106,siika,,kabah,1.88,62,-19,43
1105,Uneven Stairs,,snydej,3.18,18,-2,16
1104,as,,kabah,2.16,21,-10,11
1103,Siika Da Kala ^3,,style,2.11,45,-5,40
1100,siika da kala,,style,2.18,30,-9,21
1099,Follow the map,,trold,3.38,7,-1,6
1098,Snaky,,trold,3.00,22,0,22
1097,Spiral,,user137,1.91,89,-5,84
1096,Pond and bridge,,ebusiness,3.86,6,0,6
1095,Chess Knight II,,karby,3.06,17,0,17
1094,Count to 4,,ebusiness,3.67,19,0,19
1093,Frogger _'(**)'_,,zerosavant,2.15,50,-5,45
1092,Just Around the Corner,,beaza,3.64,8,-3,5
1091,Binary path,,ebusiness,3.46,14,0,14
1090,2 bits,,ebusiness,3.36,12,-1,11
1089,Simple red/green,,pulver,2.68,25,-4,21
1088,Chain Links,,beaza,2.37,67,-1,66
1087,4 bits,,ebusiness,4.30,10,0,10
1086,Binary,,ebusiness,4.24,17,0,17
1085,"Red Light, Green Light",,beaza,2.48,48,0,48
1084,Routine puzzle,,ebusiness,3.23,13,-1,12
1083,Chess Knight,,ngen,2.39,37,-2,35
1081,random count,,timotheeee,3.40,4,-3,1
1080,butterfly ,,timotheeee,3.05,12,-5,7
1079,Egypt :D,,ngen,2.79,25,-4,21
1078,insect,,timotheeee,2.96,22,0,22
1074,easyyyyyy,,beko,1.47,126,-36,90
1073,LOVE,,beko,1.57,196,-30,166
1071,hammered using only F1 ,,timotheeee,2.03,88,-9,79
1070,Get The Reds 2,,rafaelromao,3.07,33,0,33
1067,it s very easy,,beko,1.36,76,-53,23
1066,symmetry + paint 2,,timotheeee,3.00,13,-3,10
1065,symmetry + paint,,timotheeee,4.25,1,-2,-1
1064,Slim Cross 3,,rafaelromao,2.13,38,-13,25
1063,Slim Cross 2,,rafaelromao,2.10,56,-10,46
1062,Slim Cross,,rafaelromao,1.93,76,-10,66
1061,Boomerang,,boomernickels,1.91,116,-10,106
1060,Red Continuation,,rafaelromao,2.91,22,0,22
1059,Odd or Even,,feddas,1.93,112,-21,91
1058,Drive Around the Neighborhood,,boomernickels,3.04,19,-1,18
1057,RECUrecursionRSION,,boomernickels,4.44,8,0,8
1056,Path of Darkness - Flip Flop,,markbyers,4.07,15,0,15
1055,V,,timotheeee,2.97,27,-2,25
1054,[space],,timotheeee,1.96,85,-14,71
1053,big blob,,timotheeee,4.00,1,-1,0
1052,5 fonction,,timotheeee,2.37,45,-8,37
1051,Go Back,,sticky,3.14,21,-1,20
1050,Shuriken Again,,rafaelromao,3.11,19,-4,15
1049,Compact Instructions,,sticky,3.17,24,0,24
1048,Path of Darkness,,markbyers,3.50,21,0,21
1047,Double Symmetry,,markbyers,4.33,10,0,10
1046,rhino + paint,,timotheeee,5.00,1,-1,0
1045,big blue cross,,timotheeee,2.66,27,-12,15
1043,Fermat's Spiral 3,,markbyers,3.54,43,-1,42
1042,Fermat's Spiral 2,,markbyers,2.09,83,-4,79
1041,Stronghold Hole,,axelbrz,2.91,19,-5,14
1040,Swiss flag,,timotheeee,1.51,228,-46,182
1039,robot-ZZle,,timotheeee,3.75,9,-3,6
1038,turn around 5,,timotheeee,3.15,12,-2,10
1037,Stairs and Ladders,,sticky,3.64,15,0,15
1035,blue bar,,timotheeee,2.96,25,-5,20
1034,around and around,,timotheeee,2.07,45,-18,27
1033,Counting - Green,,markbyers,3.44,34,0,34
1032,"Enter, don't enter II",,axelbrz,1.60,276,-23,253
1031,Ruby String,,axelbrz,2.85,37,-1,36
1030,Connecting blue ones,,axelbrz,3.19,31,0,31
1029,Xmas Lights,,sticky,2.34,60,-2,58
1027,red rectangle,,timotheeee,2.88,10,-6,4
1026,forklift 2,,timotheeee,5.00,0,0,0
1025,Spiral Out,,snydej,3.07,11,-2,9
1024,Around and Around... the Donut,,beaza,3.25,10,0,10
1023,Symmetry - Tree,,markbyers,5.00,5,0,5
1022,Widening 2,,markbyers,3.92,13,0,13
1021,New Paint Job,,snydej,3.08,14,0,14
1020,Swirl,,markbyers,3.14,33,0,33
1019,Straight Line 2,,beaza,3.29,15,0,15
1018,Straight Line 1,,beaza,3.28,16,0,16
1017,Little Alcoves,,beaza,3.06,12,-3,9
1016,Red - Blue,,zephyrmation,2.93,44,0,44
1015,forklift,,timotheeee,3.80,2,-4,-2
1014,Counting - Difference,,markbyers,3.71,8,0,8
1013,Widening,,markbyers,3.47,17,0,17
1012,stack,,timotheeee,2.97,25,-3,22
1011,Heaven Star,,axelbrz,2.14,33,-13,20
1010,From Hell to Heaven,,axelbrz,4.00,3,-1,2
1009,Prior Planning,,snydej,3.88,9,0,9
1008,Dampening II,,snydej,2.67,39,-2,37
1007,Dampening I,,snydej,2.29,60,-5,55
1006,Spinner,,hanro,1.68,96,-31,65
1004,Chip II,,axelbrz,1.80,168,-13,155
1003,Fermat's Spiral,,rafaelromao,1.77,129,-19,110
1002,A Different Kind Of Spiral,,rafaelromao,3.14,10,-3,7
1001,Around and Around... and Around,,beaza,3.23,9,-1,8
1000,Get The Reds,,rafaelromao,1.32,436,-67,369
999,Get The Greens,,rafaelromao,1.44,553,-38,515
997,Wiggle 3,,markbyers,3.18,20,-2,18
996,Pac Man,,beaza,2.88,25,0,25
995,Twinkle,,markbyers,2.22,23,-6,17
994,single bird,,timotheeee,2.95,15,-4,11
993,paint your own path,,timotheeee,5.00,0,-1,-1
992,rotaded square,,timotheeee,3.17,11,-6,5
991,Outer Outer Path,,snydej,3.90,9,-1,8
990,Counting - First Sequence,,markbyers,3.43,22,0,22
989,Counting - Last Sequence,,markbyers,2.90,24,-1,23
988,Follow The Wall,,rafaelromao,3.07,26,-1,25
987,Counting - Single Greens,,markbyers,3.82,11,0,11
986,Counting - Start / Stop,,markbyers,3.79,15,-2,13
985,Counting And Halving,,markbyers,3.92,13,0,13
984,Pinwheel,,beaza,2.19,51,-3,48
983,Stack Memory Tutorial 3,,markbyers,3.05,45,0,45
982,Stack Memory Tutorial 2,,markbyers,3.10,46,0,46
981,Stack Memory Tutorial 1,,markbyers,2.94,82,-3,79
980,Simple Cross 3,,rafaelromao,1.95,89,-15,74
979,symmetry-???,,timotheeee,2.67,32,-3,29
978,learning stack,,timotheeee,2.77,25,0,25
977,Count Green Pairs,,markbyers,3.09,22,-1,21
976,another ninja star,,timotheeee,2.88,25,0,25
975,easy,,timotheeee,1.70,115,-23,92
974,Pyramid,,beaza,3.45,13,0,13
973,Wiggle 2,,beaza,3.12,28,-1,27
972,Count Sequences,,markbyers,3.04,26,-1,25
971,Counting and Doubling 2 (v2),,markbyers,3.50,18,0,18
970,Counting and Doubling 2,,markbyers,3.63,14,0,14
969,hammer,,timotheeee,3.07,28,-2,26
968,double bird,,timotheeee,3.33,3,-2,1
967,red square,,timotheeee,3.67,2,-1,1
965,Tetris Pieces,,dvorjakque,2.85,19,0,19
964,Wiggle,,beaza,3.69,15,-1,14
963,Rose,,rafaelromao,2.08,94,-5,89
962,Castle Walls,,beaza,2.63,46,-1,45
961,Straying from the path II,,wallacoloo,3.36,10,0,10
960,Maximum 2,,markbyers,4.67,7,0,7
959,circle,,pedrorz,1.44,376,-42,334
958,blue,,timotheeee,3.13,8,-2,6
957,code 2,,timotheeee,1.68,150,-31,119
956,Space Invaders,,beaza,3.12,14,-2,12
955,Carbon Copy: Vertical Flip,,beaza,3.53,14,0,14
954,Counting and Doubling,,markbyers,4.70,11,0,11
953,Equal Ends,,markbyers,3.73,12,0,12
952,botton,,timotheeee,2.95,16,-1,15
950,bottle,,timotheeee,2.83,26,-6,20
949,Guess The Solution,,dooey100,4.50,1,-3,-2
948,Inner Path,,snydej,3.33,16,-1,15
947,Outer Path,,snydej,3.00,20,-1,19
946,Tetris,,dvorjakque,4.29,8,-1,7
945,Laser Reflection,,axelbrz,2.31,56,-3,53
944,Simple Cross 2,,rafaelromao,1.93,122,-6,116
943,Simple Cross,,rafaelromao,1.72,202,-15,187
942,Count Green,,markbyers,4.71,8,0,8
941,Chameleon Spiral 2,,markbyers,2.92,39,0,39
940,Donkey Kong,,beaza,2.00,34,-16,18
939,Defender,,beaza,3.08,6,-4,2
938,Carve Your Own Puzzle,,beaza,3.33,11,-1,10
937,Simple Spiral,,azure,2.63,43,-2,41
936,big labirint,,pedrorz,1.38,67,-33,34
935,mad,,pedrorz,1.41,416,-80,336
934,Almost Square,,beaza,3.30,21,0,21
933,Unmarked Turn Spiral 3,,markbyers,4.09,9,0,9
932,Unmarked Turn Spiral 2,,markbyers,3.25,13,0,13
931,Unmarked Turn Spiral 1,,markbyers,2.28,61,-4,57
930,mirror image 2,,timotheeee,2.64,39,-8,31
929,hammer,,timotheeee,2.70,25,-14,11
928,The Scarlet Cross,,dvorjakque,3.08,8,-3,5
927,Missile Command,,beaza,4.20,2,-3,-1
926,Early Warning 2,,beaza,2.77,31,-1,30
925,Staircases,,azure,3.06,16,0,16
924,Bullseye,,azure,4.25,3,0,3
923,Cross With Holes,,markbyers,2.80,17,-1,16
922,q with a very big hat,,timotheeee,2.81,28,-3,25
921,Obstacle Course,,beaza,3.36,11,-1,10
920,nevereasy,,nevereasy,1.81,117,-22,95
919,q at the end,,timotheeee,2.59,50,-5,45
918,red green is the code III,,timotheeee,2.19,67,-20,47
917,Day at the Beach,,beaza,3.22,9,0,9
916,Ternion,,dvorjakque,2.76,31,-2,29
915,Stargate,,karby,2.78,26,0,26
914,Ninja Throwing Star II,,beaza,3.86,7,-3,4
913,key,,timotheeee,2.83,35,-4,31
912,grid,,timotheeee,2.26,47,-6,41
911,Minefield,,beaza,3.50,7,-1,6
910,Chameleon Spiral,,markbyers,4.24,21,0,21
909,Stack and Turn 2,,markbyers,2.80,49,-1,48
908,Four Corners Of The World,,rafaelromao,3.07,17,-1,16
907,Backtrack Spiral,,rafaelromao,2.51,65,-1,64
906,Square Cross Paths,,rafaelromao,3.38,9,-1,8
905,Efficiency,,matchu,2.70,25,-7,18
904,The Weakest Link,,matchu,2.33,62,-7,55
903,The Narrow Way,,xodusprime,2.55,37,-1,36
902,Pandora's Pipes,,dvorjakque,3.03,34,-2,32
901,Sonic,,matchu,3.14,6,-3,3
900,You've Got Mail,,matchu,3.12,11,-2,9
899,Magic square,,hanami279,3.17,7,-2,5
898,Secret Code,,matchu,2.57,48,-3,45
897,the long path,,timotheeee,2.92,18,-3,15
896,Return,,sticky,2.79,46,0,46
895,Ends,,sticky,2.87,41,-3,38
894,VII (once more),,sticky,3.50,1,-4,-3
893,Split II (not as hard),,snydej,4.29,6,0,6
892,Split II (hard),,snydej,4.57,7,0,7
891,flip and rotate,,alvarom,3.88,8,0,8
890,Waffle Iron,,matchu,3.07,10,-1,9
889,Straightforward,,matchu,2.09,73,-7,66
888,Forty-Two,,matchu,1.98,20,-21,-1
885,No problem,,matchu,3.63,3,-2,1
884,Symmetry - Double Width,,markbyers,3.28,19,0,19
883,Gridlock :: Version Bland,,matchu,2.51,34,-3,31
882,Gridlock,,matchu,1.35,596,-115,481
881,Easy Double Spiral,,azure,2.88,44,-2,42
880,split,,wallacoloo,3.89,7,0,7
878,Squre2,,nima_,2.07,87,-12,75
877,Square,,nima_,2.66,23,-7,16
876,C is for Complex,,beaza,3.25,12,-1,11
875,Devil's Whirl,,dvorjakque,2.87,20,0,20
874,Symmetry - Spiral Painting,,markbyers,4.00,9,0,9
873,T is for Trivial,,beaza,1.97,99,-5,94
872,red plane,,timotheeee,2.81,34,-7,27
871,Fibonacci Spiral II,,dannythorne,2.58,17,-10,7
870,Two-Pass,,cybermg,3.83,4,0,4
869,Energy Overload - Pit Stops,,beaza,3.31,14,-2,12
868,Distractions,,mheiberg,3.00,12,-1,11
867,Energy Overload - No Pit Stops,,markbyers,3.13,13,-1,12
866,The Lost Woods,,dvorjakque,2.50,10,-9,1
865,The Evil Box,,dvorjakque,3.17,9,-7,2
863,minus (part 1),,timotheeee,2.06,82,-7,75
862,Spiralnaut,,cybermg,3.69,15,0,15
861,mirror,,timotheeee,2.60,40,-5,35
860,Azure Key,,dvorjakque,2.89,29,-2,27
859,Jade Key,,dvorjakque,3.40,17,0,17
854,hammer time,,sillymystery,1.33,135,-31,104
853,Energy Overload,,beaza,3.16,15,-2,13
852,Batteries Not Plus Paint III,,azure,3.65,15,-1,14
851,Batteries Plus Paint II,,azure,3.64,14,0,14
850,Hourglass,,rafaelromao,2.32,52,-4,48
849,Airplane 2,,rafaelromao,3.24,28,0,28
848,Crimson Key,,dvorjakque,2.63,41,-4,37
847,Lost at Sea,,dvorjakque,1.75,140,-15,125
846,The Mysterious Stair,,dvorjakque,1.90,131,-4,127
845,a big path for two stars,,timotheeee,2.22,39,-17,22
844,Turn on the Third Color,,snydej,3.75,8,0,8
843,Matching Lengths,,snydej,5.00,6,0,6
842,turn on red,,timotheeee,2.28,42,-5,37
841,The Stack,,dvorjakque,1.74,185,-20,165
840,The Stack,,dvorjakque,1.42,492,-91,401
839,Reverse Polarity,,dvorjakque,3.46,25,-2,23
838,"Push, Pop, and Peek",,snydej,4.36,12,0,12
837,Try Recursion,,thisisthename,1.92,83,-13,70
835,Hangman,,beaza,2.81,23,-1,22
833,x,,ammonzing,1.92,146,-7,139
832,Messy path,,willbir,3.22,9,0,9
831,Intermediate spiral,,willbir,4.18,6,-1,5
830,Wave,,rafaelromao,2.25,56,-4,52
829,Stacked,,sticky,3.56,13,0,13
828,Dizzy,,mheiberg,2.59,64,-3,61
827,when to turn ?,,timotheeee,2.28,68,-2,66
826,crane,,timotheeee,2.51,39,-4,35
825,Carbon Copy,,beaza,3.17,5,-1,4
824,Funny Fishes,,feddas,2.20,28,-14,14
823,Messy Greens 2,,hbandura,3.06,18,0,18
822,Messy greens,,hbandura,2.81,31,0,31
821,Sir Countalot,,rilo,3.55,6,-4,2
820,A tortuous path for one star 2,,rafaelromao,2.85,30,0,30
819,Green Lights,,rafaelromao,3.67,1,-2,-1
818,AIR Rocket,,timotheeee,2.83,18,-3,15
817,Slinky,,beaza,3.12,15,0,15
816,island,,timotheeee,2.20,62,-6,56
815,Hole,,rilo,3.40,8,0,8
814,Go For a Swim II,,snydej,4.50,8,0,8
813,Go For a Swim I,,snydej,3.55,10,0,10
812,JESUS FISH!,,ammonzing,3.38,7,-7,0
811,Counting by turns,,0cache,1.97,90,-6,84
809,p,,timotheeee,1.90,104,-15,89
806,double call stack,,timotheeee,3.24,26,-1,25
805,double stack,,timotheeee,1.82,195,-20,175
804,Grenade,,sillymystery,1.29,29,-19,10
803,Magnetic Repulsion,,beaza,3.25,11,0,11
802,Missed Turn,,mheiberg,2.53,50,-4,46
801,Plus (part 2),,beaza,2.89,41,-2,39
800,Plus (part 1),,beaza,1.33,621,-86,535
799,Paint Brush,,beaza,2.56,23,-5,18
798,Abacus II,,beaza,4.33,6,-1,5
797,Directed Graph Traversal,,snydej,3.69,19,0,19
795,Binary Subtraction,,snydej,4.43,6,0,6
794,Binary Addition,,snydej,4.29,6,0,6
793,Abacus,,beaza,1.93,47,-26,21
792,Waiting for my turn,,hbandura,3.88,7,0,7
791,Progressive Jackpot,,beaza,2.86,30,0,30
790,Turning Green,,markbyers,3.04,18,-2,16
789,3-Bar With Hole,,markbyers,2.67,42,-1,41
788,Red-Blue cross (redone),,rilo,3.15,9,-1,8
787,Piece of cake,,jedistef,2.09,80,-10,70
786,The Map,,petwolverine,3.44,19,0,19
785,sorting IV - tab order,,alvarom,5.00,3,0,3
784,run 4 ur life!,,ammonzing,2.84,27,-1,26
783,Spiral Technique III,,axelbrz,2.44,55,-3,52
782,binary counting - 7bits,,wallacoloo,3.70,11,0,11
781,Black Fences,,rafaelromao,3.17,8,-3,5
780,Criss Cross,,ryusho,1.97,143,-5,138
779,Turn on Four of a Kind,,markbyers,2.19,56,-9,47
778,Red-blue cross,,rilo,1.60,132,-36,96
777,Skip The Hole,,markbyers,2.48,49,-3,46
776,Turn on Pair,,markbyers,2.09,108,-4,104
775,Two Recursions,,rilo,3.09,12,-3,9
774,rainbow spiral,,timotheeee,2.10,82,-10,72
773,LUCKY CHARMS!,,ammonzing,2.35,72,-3,69
772,Shoot to kill!,,ammonzing,1.84,106,-16,90
771,"Memory hole, or a memory for holes",,petwolverine,3.00,37,0,37
770,HANG MAN,,ammonzing,1.81,170,-9,161
769,Batteries Plus Paint,,azure,4.58,14,0,14
768,Squares With Holes,,markbyers,2.28,41,-6,35
767,abiss,,avatar,1.85,66,-29,37
766,Rainbow Spiral 2,,markbyers,3.45,15,0,15
765,Rainbow Spiral,,markbyers,2.35,51,0,51
764,big red X 2,,timotheeee,1.31,36,-23,13
763,square,,timotheeee,1.86,25,-19,6
762,blue -> red,,timotheeee,3.21,23,0,23
761,mirror percent,,timotheeee,2.39,49,-1,48
760,Hey,,azechiel,5.00,2,-1,1
759,Battery 2,,markbyers,3.93,15,0,15
758,Rounded Corner Spiral,,markbyers,1.82,148,-9,139
757,Three of a Kind,,markbyers,2.72,31,0,31
756,Pairs,,markbyers,2.52,44,-2,42
755,Blue Star Bizzar,,ammonzing,2.46,47,-1,46
754,Chambers,,markbyers,3.30,13,0,13
753,X Marks the Spot,,beaza,3.67,5,-1,4
752,Donut,,beaza,3.00,7,-2,5
751,Cookie Monster,,beaza,2.94,16,-3,13
749,Easy ant,,kraker,3.63,5,-5,0
748,"Symmetry - Left on Green, Right on Red",,markbyers,3.35,21,-1,20
747,Measurements 2,,markbyers,3.41,22,0,22
746,Waterfalls,,markbyers,3.22,27,0,27
745,glasses,,timotheeee,2.04,116,-8,108
744,Long Journey 3,,rafaelromao,3.21,12,0,12
743,Battery,,cybermg,3.08,24,-1,23
742,Water Bucket in a Welll,,beaza,2.51,36,-7,29
741,Grand Prix VIII,,beaza,2.72,29,0,29
740,Sorting III,,snydej,4.35,19,0,19
739,Color Explosion,,beaza,3.43,5,-2,3
737,Parity Correction,,cybermg,3.41,17,-1,16
736,stack and turn,,timotheeee,1.84,191,-22,169
735,Obstructions II,,snydej,3.15,26,0,26
734,Primes,,igoro,3.05,20,-1,19
733,Grand Prix VII,,beaza,3.08,8,-5,3
732,Equal?,,markbyers,3.50,15,0,15
731,snake,,timotheeee,3.00,11,-3,8
730,Enqueue and Dequeue,,snydej,3.88,6,0,6
729,Push and Pop,,snydej,3.61,21,0,21
728,no F3,,timotheeee,1.94,99,-31,68
727,hammered 3,,timotheeee,2.47,46,-4,42
726,Chip,,axelbrz,1.74,169,-18,151
725,Not so small square II,,axelbrz,3.00,3,-2,1
724,Not so small square,,axelbrz,3.57,4,-1,3
723,"Enter, don't enter",,axelbrz,2.35,73,-4,69
722,Just another spiral variation II,,axelbrz,2.81,25,-4,21
721,Just another spiral variation,,axelbrz,2.31,55,-8,47
720,Get them all!,,axelbrz,1.48,38,-29,9
719,Convex Hole,,snydej,2.94,31,0,31
718,eyes,,timotheeee,2.01,45,-19,26
717,strange key,,timotheeee,2.31,42,-20,22
716,Obstructions,,snydej,2.82,45,-1,44
715,Cross the Bridges,,snydej,4.00,14,0,14
714,Ups and Downs,,snydej,2.30,93,-2,91
712,Skewed Maze,,snydej,2.62,46,-2,44
711,star cloud,,timotheeee,2.88,14,-7,7
710,A lot of right...,,gimoz,2.04,94,-20,74
709,Dead Center,,beaza,1.67,154,-26,128
707,who can do this?,,samual,1.47,65,-27,38
706,blades,,timotheeee,2.12,60,-10,50
705,red carpet,,timotheeee,2.77,8,-5,3
703,Random Walk II,,markbyers,3.86,3,-5,-2
702,Linked List III,,markbyers,4.50,13,0,13
701,Random Walk,,markbyers,3.88,3,-5,-2
700,Long Journey 2,,rafaelromao,3.75,3,0,3
699,Shuriken's Revenge,,markbyers,3.33,13,-2,11
698,Zigzag,,rilo,3.08,6,-5,1
697,Incremental,,rilo,3.44,10,-9,1
696,green cross,,samual,1.62,125,-45,80
695,Going to Oz,,beaza,2.46,59,-1,58
693,The Three Red Stars,,timotheeee,2.28,48,-13,35
692,two red eggs,,timotheeee,2.74,21,-4,17
691,hahaha,,timotheeee,1.53,265,-76,189
690,Bad Medicine,,0cache,3.22,17,-1,16
689,Minimum,,markbyers,4.80,6,0,6
688,Maximum,,markbyers,4.57,9,0,9
687,Hurricane,,catbert,3.00,19,0,19
686,Is it simple?,,,4.40,2,-2,0
685,Three,,rilo,3.80,1,-2,-1
684,Pile up the stars,,rilo,3.60,4,-1,3
683,Is it easy?,,paninmischa,2.81,21,-5,16
682,Stack,,beaza,1.81,69,-55,14
681,Grand Prix VI,,beaza,3.13,6,-1,5
680,the hard spiral,,timotheeee,2.07,77,-18,59
679,learning the call stack,,timotheeee,3.40,29,-1,28
676,Linked List II,,snydej,4.06,104,0,104
675,Grand Prix V,,beaza,4.60,3,-2,1
674,Elephantrix,,azechiel,2.37,7,-11,-4
673,Ninja Throwing Star,,beaza,2.51,40,-4,36
672,Grand Prix IV,,beaza,3.36,8,-1,7
671,Greek key I,,0cache,1.38,428,-104,324
670,Grand Prix III,,beaza,3.80,7,-1,6
669,Halloween(5),,kraker,1.82,66,-36,30
668,Halloween(4),,kraker,2.01,104,-23,81
667,Halloween(3),,kraker,3.00,17,-6,11
666,Halloween(2),,kraker,2.38,65,-3,62
665,spiral,,timotheeee,1.49,314,-78,236
664,big red X,,timotheeee,1.80,230,-31,199
663,Can you see that?,,axelbrz,3.71,6,0,6
662,Coloring stars!,,axelbrz,3.83,5,-3,2
661,Easy Worm,,axelbrz,2.06,63,-20,43
660,Pivoting,,axelbrz,2.81,20,-4,16
659,Clock!,,axelbrz,4.00,2,-2,0
658,Spiral Technique II,,axelbrz,3.17,13,-3,10
657,Chess Horse,,axelbrz,2.75,33,-2,31
656,Limit your stack!,,axelbrz,3.47,1375,-34,1341
655,Basics: Easy Spiral,,axelbrz,1.68,232,-31,201
654,Linked List,,snydej,3.64,128,0,128
651,Horizontal Egg,,axelbrz,2.83,6,-7,-1
650,Spiral Technique I,,axelbrz,2.04,72,-20,52
649,Big random area,,axelbrz,?,0,0,0
648,Tight Area,,rafaelromao,2.41,1945,-155,1790
647,Christmas Lights 2,,thenick22,3.17,12,-3,9
645,Lessons Learned,,bahkoo,3.35,23,0,23
644,Right on red,,sarsdp,2.55,3679,-168,3511
643,easy,,paninmischa,1.42,394,-100,294
642,Grand Prix II,,beaza,4.57,4,-2,2
641,Interpolation,,snydej,4.40,15,0,15
640,Star Striped,,bahkoo,2.96,29,0,29
639,Information Gathering,,snydej,3.67,27,0,27
638,Algebra,,axelbrz,2.38,43,-14,29
637,Two Islands,,beaza,5.00,0,-1,-1
636,Litebulb,,catbert,1.30,809,-275,534
635,Clean Your Room,,bahkoo,2.82,45,0,45
634,mountains,,timotheeee,2.29,3310,-118,3192
633,Grand Prix I,,beaza,4.60,1,-1,0
632,maze,,timotheeee,2.52,36,-12,24
631,Symmetry - Arrows,,markbyers,3.64,8,0,8
629,Division 2,,markbyers,4.29,9,0,9
628,Handcuffs,,thenick22,3.00,222,-4,218
627,Guess the formula,,rafaelromao,2.41,51,-9,42
626,:),,jesusgeek94,1.42,372,-92,280
625,Multiplication,,chief,3.80,10,0,10
624,Imperfect Reflection,,snydej,3.79,16,0,16
623,One function,,snydej,3.42,22,-1,21
622,Jigsaw,,markbyers,5.00,0,0,0
621,Made of Sun,,xodusprime,2.79,24,-3,21
620,Symmetry - Ribbon,,markbyers,3.43,16,0,16
619,Two Stroke,,xodusprime,1.52,227,-78,149
618,Turn around 4 - Tree,,markbyers,3.82,17,0,17
617,Turn around 3,,wallacoloo,3.02,51,0,51
616,Turn around 2,,markbyers,2.63,995,-39,956
615,Turn around,,markbyers,2.55,1290,-46,1244
614,Symmetry - Parity Snake,,markbyers,3.75,15,0,15
613,Symmetry - Dizziness,,markbyers,4.23,13,0,13
612,Reuse,,ssancho,3.14,30,0,30
611,Line up the stars,,rilo,1.88,140,-21,119
610,:3,,center566,1.52,237,-78,159
608,Symmetry - Forest Path,,markbyers,5.00,6,0,6
607,Palindromes 3,,markbyers,4.80,4,0,4
606,Halloween,,kraker,3.24,15,-4,11
605,Pong 2,,ssancho,2.79,34,-2,32
604,Stealth Bombers over the Sea,,vparot,2.28,70,-16,54
603,Take The Blue,,vparot,2.17,91,-8,83
602,Symmetry - Maze,,markbyers,4.86,9,0,9
601,Symmetry - Don't Miss The Turn,,markbyers,3.67,13,0,13
600,Palindromes 2,,markbyers,4.43,7,-1,6
599,I.N.R.I.,,rilo,4.00,0,-2,-2
598,Would they still play sports...,,thenick22,3.17,6,0,6
597,Cumulative Effect,,chief,3.49,116,-1,115
595,Just Another Trees,,ssancho,2.94,35,0,35
594,Binary Tree,,beaza,3.06,39,0,39
593,Snowflake,,markbyers,3.11,17,0,17
592,super easy hammered,,jesusgeek94,1.42,401,-132,269
591,Action Replay,,markbyers,3.58,21,0,21
590,Symmetry - Warning Signs,,markbyers,4.11,9,0,9
589,Palindromes,,markbyers,3.14,6,0,6
588,a Maze 2,,timotheeee,1.67,208,-71,137
587,The Cross,,diechort,2.44,1758,-71,1687
586,Doubletime,,chief,3.46,11,-2,9
585,Easy to Distract,,ssancho,4.00,8,0,8
584,Boost Spiral,,rafaelromao,3.35,237,-7,230
583,Autonomous Collective,,thenick22,2.36,55,-13,42
582,Addi(c)tive Trip,,vparot,4.10,6,-1,5
581,Out of Paint,,markbyers,3.70,9,0,9
580,Broken Connections,,markbyers,3.14,21,-1,20
579,Green Borders,,rafaelromao,1.80,193,-25,168
578,Pong,,ssancho,1.78,174,-31,143
577,Symmetry - Right on Green,,markbyers,3.06,47,-1,46
576,Symmetry - Zigzag,,markbyers,3.47,20,0,20
575,easy hammered,,timotheeee,2.45,74,-9,65
573,Twisted Tree,,markbyers,3.17,12,0,12
572,monster 2,,timotheeee,1.95,80,-24,56
571,Bumbling Bee,,thenick22,2.30,1755,-25,1730
570,Blue X,,rafaelromao,1.93,2763,-218,2545
569,Plus++,,ssancho,2.52,49,-12,37
567,Linked Rings,,markbyers,3.44,122,-1,121
566,1,,timotheeee,1.59,193,-61,132
565,diagonale,,timotheeee,1.46,436,-67,369
564,easy puzzle,,timotheeee,1.43,413,-54,359
563,Symmetry - Diagonal Path,,markbyers,3.74,25,0,25
562,Recursion Review,,cobaltblue,1.88,180,-13,167
561,Swim,,markbyers,2.97,27,-3,24
559,Diagonal Path,,markbyers,1.94,169,-20,149
558,8 ways,,willbir,3.39,185,-1,184
556,Dedication,,rilo,2.10,28,-28,0
555,The green mile,,rilo,2.92,693,-9,684
554,Two Steps From The Road,,markbyers,3.23,14,-3,11
553,horseplay,,cobaltblue,2.66,22,-5,17
552,Forest Path,,markbyers,3.71,126,-2,124
551,CP,,ddakev,2.70,31,-9,22
549,Minefield,,markbyers,5.00,8,0,8
548,Cube Extreme,,ammonzing,2.33,851,-51,800
547,The Cube,,ammonzing,2.44,73,-9,64
546,Color Racetrack,,rilo,3.00,24,-2,22
545,Ternary Tree Symmetry,,markbyers,3.80,13,0,13
544,Are we there yet?,,danr,3.83,2,-4,-2
543,sorting II,,alvarom,4.54,10,0,10
542,Vortex,,markbyers,3.57,21,-1,20
541,Ugly Helicopter,,rilo,3.86,3,-2,1
540,Turn Right At The Stars,,rafaelromao,2.84,42,-2,40
539,Hypnotize,,ammonzing,2.14,2354,-144,2210
538,Corners,,rilo,3.67,8,-1,7
537,Recursed Revisited,,rilo,4.50,5,-1,4
536,Recursed,,rilo,2.60,773,-16,757
535,RoBallerina,,rilo,4.00,2,-3,-1
534,Perspective IV,,markbyers,3.73,13,0,13
533,O?,,rilo,3.20,8,-3,5
532,Spirelli,,rilo,2.73,919,-14,905
531,Crazy Checkers,,rilo,3.27,3,-5,-2
530,Happy,,rilo,2.39,88,-7,81
529,One lap,,rainault,3.03,31,-1,30
528,Long Journey,,rafaelromao,3.09,21,0,21
526,Bumpin' around,,rainault,3.37,162,-5,157
525,"Upstairs, downstairs 3",,rafaelromao,2.76,40,-3,37
524,"Upstairs, downstairs 2",,rafaelromao,1.80,259,-24,235
523,Six-way,,stufi04,1.72,248,-54,194
520,Shoots and Ladders,,ammonzing,2.86,45,-1,44
519,star path,,ajji,1.42,49,-24,25
518,Skull Island,,beaza,4.50,2,-2,0
516,Forward Slash,,beaza,2.82,39,0,39
514,Evil Knievel's Evil Cave,,evilknievel,2.41,946,-99,847
513,mind the gap,,alvarom,3.04,154,-21,133
512,From the Ministry of Silly Walks,,azure,3.87,14,-4,10
511,Up then Down,,ajji,2.82,582,-9,573
510,Lawn Mower,,rafaelromao,2.43,88,-4,84
509,The Bends,,markbyers,3.68,21,0,21
508,Holiday Tree,,beaza,3.23,14,0,14
506,Shoot for the Stars,,ammonzing,2.33,58,-10,48
505,Turn America Green,,ammonzing,2.26,92,-19,73
504,"Sorry, my kid barfed on your carpet",,thenick22,3.57,5,-1,4
503,marine march ,,ammonzing,2.77,371,-24,347
502,Skip after blue,,dennyrolling,3.09,20,-1,19
501,Herring,,taintedfalcon,2.38,63,-15,48
500,Movable paint,,rainault,2.98,322,-2,320
499,Feeling a little cross,,rainault,2.32,697,-47,650
498,Flag,,rilo,2.76,18,-3,15
497,True blue,,rilo,2.44,29,-7,22
496,Starship Trooper,,rilo,2.14,120,-21,99
495,Mountain,,markbyers,3.82,12,0,12
494,Blue Bee,,rilo,2.61,84,-5,79
493,Mario,,ivort,2.18,53,-13,40
492,Recursive turning,,rainault,2.81,285,-4,281
491,Winking Bull,,taintedfalcon,3.00,15,-2,13
490,A tortuous path for one star,,rafaelromao,3.15,10,-1,9
489,Not quite Langton's,,dennyrolling,4.14,2,-3,-1
488,Bunny,,taintedfalcon,1.45,589,-113,476
486,Follow The Snakes,,markbyers,3.27,24,0,24
485,Two Greyhounds,,honey,2.94,44,-2,42
484,easy as apple pie!,,ammonzing,2.59,66,-11,55
483,spiral web,,alvarom,1.90,3630,-188,3442
482,waterfront,,alvarom,3.73,11,0,11
481,Almost Symmetric,,rafaelromao,3.50,3,-2,1
479,sorting,,alvarom,4.25,16,0,16
478,Mirror image,,willbir,3.42,31,-1,30
477,Jagged Rift,,fatbuddha,5.00,7,0,7
475,Two Stars,,fatbuddha,3.60,18,0,18
474,Command Sequence,,markbyers,4.44,9,0,9
473,Airplane,,rafaelromao,4.33,2,0,2
472,Elevator,,rafaelromao,2.88,437,-33,404
471,Burnt Bridges 2 - Snake Bridge,,markbyers,2.62,18,-7,11
470,Jagged Edge,,fatbuddha,2.86,230,-7,223
469,Fat Snake,,recursive,3.05,38,0,38
468,Stairway to Heaven,,coolchrisrm,2.26,135,-11,124
467,Traversing The Hypotenuse (finished),,wallacoloo,3.14,24,0,24
466,Traversing The Hypotenuse,,wallacoloo,3.15,25,0,25
465,Majority Rule,,markbyers,3.27,25,0,25
464,Red Herring,,willbir,4.33,6,-1,5
463,Big F,,willbir,3.21,47,-1,46
462,Just a spiral,,willbir,3.09,22,0,22
461,Bar graphs,,willbir,3.00,40,-4,36
460,comparison II,,alvarom,3.43,4,-1,3
457,impossible!!!!!!!,,jesusgeek94,1.62,38,-42,-4
456,island hopping,,wallacoloo,2.91,45,-2,43
455,Q,,quan,1.47,294,-56,238
454,Q,,quan,1.47,251,-67,184
451,Mommy's new shirt,,wilbert,1.31,50,-31,19
450,Can you rescue the lost one?,,foxfire,2.06,37,-31,6
449,Green turn,,wilbert,2.01,1287,-151,1136
448,comparison,,alvarom,4.00,8,0,8
447,When to turn?,,wallacoloo,3.77,14,0,14
446,Warning Signs,,markbyers,3.01,175,-4,171
445,/* Comments? */,,markbyers,3.68,20,-2,18
444,Not yet... not yet...,,markbyers,2.74,570,-10,560
443,Tight Fit,,zephyrmation,2.58,62,-8,54
442,Burnt Bridges,,markbyers,3.61,23,0,23
441,Peace,,dance4life51,2.69,32,-10,22
440,I hate blue!,,o0okaaskopo0o,5.00,0,0,0
439,Easy Peezy,,coolchrisrm,2.97,302,-8,294
438,Bow and arrow,,pro_master,1.45,515,-101,414
437,Spot The Difference,,markbyers,3.25,23,0,23
436,Don't miss the turn!,,wallacoloo,3.07,24,-2,22
435,Minority Rule,,markbyers,4.57,6,0,6
434,FSM Love,,frewsxcv,1.78,351,-29,322
433,One off,,xodusprime,2.67,65,-5,60
432,Stoplight,,zephyrmation,1.71,2581,-178,2403
431,Green Gates,,markbyers,3.86,7,0,7
430,rAnDoM,,h4x012,2.74,22,-5,17
429,Swimming Frog,,rafaelromao,2.86,18,-2,16
428,String Escaping,,markbyers,3.36,129,-5,124
427,Parabola,,snydej,4.43,11,0,11
426,Fractal,,snydej,4.23,12,0,12
425,Flip Flop,,azrael,1.82,1683,-55,1628
424,Swine Flu,,dbirman,1.52,223,-79,144
423,Incremental Buildup,,snydej,3.87,15,0,15
422,2 bit instructions (2),,wallacoloo,4.14,8,0,8
421,Follow the stars,,rafaelromao,2.92,22,-4,18
420,F1,,rafaelromao,2.41,87,-7,80
419,Turn And Back Again,,pinkprince,1.77,1809,-178,1631
418,scattered intructions,,wallacoloo,3.13,31,0,31
417,2 bit instructions,,wallacoloo,3.11,12,-2,10
416,Red Cross,,rafaelromao,2.06,1189,-135,1054
415,Squished Spiral,,snydej,3.55,10,0,10
414,Archimedean Spiral,,snydej,3.77,28,0,28
413,Winding Path II,,snydej,4.11,19,0,19
412,Triangle,,snydej,3.42,24,0,24
411,Perspective III,,alvarom,4.00,3,0,3
410,black windows,,matush,2.75,310,-10,300
409,Finger,,matush,2.71,56,-5,51
408,Squares,,matush,2.68,58,-5,53
407,cubicles,,wallacoloo,2.88,27,0,27
406,The Blue Dot,,snydej,3.15,19,-2,17
405,Another Hidden Rule,,snydej,2.47,101,-6,95
404,Instruction Stack,,shahbawany,3.45,27,-2,25
403,Addition Modulo 3 (Plus 1) - II,,shahbawany,3.71,4,-1,3
402,Addition Modulo 3 (Plus 1),,shahbawany,2.36,12,-12,0
401,Color Changing,,shahbawany,2.98,285,-3,282
400,Spinning Propeller,,snydej,2.98,38,-6,32
399,Modulo,,snydej,4.00,12,0,12
398,Jekyll and Hyde,,cybermg,2.73,420,-13,407
397,Hello!,,shahbawany,1.85,297,-67,230
396,Out of whack,,thenick22,2.82,63,-5,58
395,4-State FSM,,shahbawany,3.05,18,-1,17
394,Deadly Dead Ends,,snydej,3.25,22,0,22
393,Square Root,,snydej,3.02,34,-2,32
392,2-Bit Instructions,,shahbawany,2.73,318,-2,316
391,Square,,snydej,3.13,30,0,30
390,Paint-a-path,,shahbawany,2.59,24,-16,8
389,parity snake,,shahbawany,3.08,369,-8,361
388,Perspective II,,snydej,3.60,16,0,16
387,Gift Wrapped,,snydej,2.97,34,-1,33
386,The Lost Prophecy,,traditore,2.63,41,-13,28
385,double width,,shahbawany,3.13,36,-1,35
384,Funnels,,recursive,3.50,18,0,18
383,Pitfall,,delisoccer,3.07,13,-7,6
381,back on double-green,,wallacoloo,2.96,64,-1,63
380,Two Paths,,cybermg,2.66,459,-16,443
379,Winding Road,,cybermg,2.81,41,-6,35
378,Oscillations,,snydej,4.12,17,0,17
376,Leftovers,,cybermg,1.77,1715,-184,1531
375,Where to turn?,,abhishikt,2.74,23,-8,15
374,LULA,,mikle,2.00,66,-27,39
373,Scared of Kermit,,thenick22,3.03,21,-3,18
371,division,,alvarom,4.08,13,0,13
370,pitchfork,,wallacoloo,3.69,14,-1,13
369,The Cross,,cheffan,3.59,15,-2,13
368,Around the world,,saunderl,2.47,94,-10,84
367,multiplication,,alvarom,4.27,13,0,13
366,Hammered 2,,cheffan,4.21,19,-3,16
365,"Upstairs, downstairs",,rafaelromao,2.51,476,-24,452
364,R - v2,,rafaelromao,2.69,15,-9,6
363,Hammered,,emi4a,4.71,58,-3,55
362,Learning Stack 4,,abhishikt,2.88,80,-1,79
361,R,,rafaelromao,2.52,60,-17,43
359,A strange blue spot,,vladi4a,4.14,5,-3,2
358,Tree III,,snydej,3.99,75,0,75
357,Painting the stairs,,countdown_0,3.56,13,-2,11
356,Balanced Colors,,snydej,3.56,40,0,40
355,Three Color Waveform,,snydej,3.44,24,-1,23
354,Both Directions 0,,snydej,2.98,259,-1,258
353,Left or Right,,recursive,2.88,74,-1,73
352,Both Directions,,snydej,3.83,106,0,106
351,Plus or Minus One and...,,snydej,4.57,12,0,12
350,Plus or Minus One,,snydej,3.77,113,-2,111
349,Straight on RGB,,snydej,2.95,54,-4,50
348,Diagonal Branching,,snydej,3.35,21,0,21
346,Tree II,,snydej,3.64,134,-1,133
345,Orbits,,snydej,3.29,44,0,44
344,Rewind tape,,countdown_0,4.38,6,0,6
343,Writ Large,,recursive,3.79,23,0,23
342,Complete Grid,,recursive,3.42,24,0,24
341,Perspective,,recursive,3.93,16,0,16
340,Bow Tie,,timmy,2.87,16,-10,6
339,complement mirror,,alvarom,3.76,22,0,22
338,First Impressions,,snydej,4.00,11,0,11
337,log base 2,,alvarom,3.72,17,0,17
336,Missing tiles,,abhishikt,3.20,34,0,34
335,Key mechanism,,andos,3.04,69,0,69
334,Learning Stack 3,,abhishikt,3.39,69,-1,68
333,Learning Stack 2,,abhishikt,2.36,613,-13,600
332,Power-of-2 generator,,igoro,3.63,180,-3,177
330,Learning Stack,,abhishikt,2.29,634,-42,592
329,Layered Sheets,,snydej,3.75,76,0,76
328,Replication Engine,,snydej,4.16,113,0,113
327,Seven Squares,,blake,3.05,21,0,21
326,Regular Holes,,snydej,3.67,16,-2,14
325,Return of Robo 2,,abhishikt,2.94,55,-3,52
324,Offset Tiles,,troc,3.12,21,-7,14
323,Red Bean,,troc,3.91,6,-5,1
322,Bigger is better,,snydej,3.71,23,0,23
321,Rift,,snydej,4.68,21,0,21
320,up or down?,,wallacoloo,2.41,611,-16,595
319,1 step forwards...,,wallacoloo,3.56,39,0,39
318,Arithmetic,,esef,3.04,226,-2,224
317,Divide by 2 - no tricks,,snydej,3.41,41,0,41
316,Simply Connected Shape II,,snydej,3.68,14,0,14
315,Simply Connected Hack,,recursive,3.29,17,-3,14
314,triangle towers,,wallacoloo,3.26,35,0,35
313,Colorful Path,,snydej,3.08,181,-3,178
312,Incomplete Weave,,snydej,3.59,17,-1,16
311,Follow directions II,,snydej,3.50,112,-3,109
310,Very Early Warning,,snydej,3.68,72,0,72
309,Early Warning,,snydej,2.69,480,-7,473
308,Blobs and Bridges,,snydej,3.62,23,0,23
307,Double Spiral,,snydej,3.48,62,-2,60
305,Follow directions,,snydej,3.50,100,0,100
304,Simply Connected Shape,,snydej,4.38,11,0,11
303,The Deathly Hallows,,traditore,2.41,53,-29,24
302,Use the map II,,snydej,3.90,24,0,24
300,Bridge to 2nd building,,alvarom,3.56,34,0,34
299,Last One Part 2,,sungjin,4.33,0,-2,-2
298,Eeek,,sungjin,2.85,8,-11,-3
297,Spinning Madness Part3,,sungjin,4.50,2,-3,-1
296,Shot Gun,,sungjin,1.73,17,-16,1
295,Sea of stars,,abhishikt,1.82,145,-35,110
294,Search the World,,snydej,4.25,12,0,12
293,Multiple Personalities,,snydej,3.15,43,0,43
291,Huh? Part2,,sungjin,3.28,169,-4,165
290,Spinning Madness Part2,,sungjin,2.50,37,-11,26
289,Colorful Bar,,sungjin,1.77,1686,-99,1587
288,Aim for Blue dot,,sungjin,2.07,45,-19,26
287,Huh?,,sungjin,1.45,314,-67,247
286,Measurements,,recursive,3.38,39,0,39
285,The Skull,,deepak,1.91,1653,-52,1601
284,Flood fill again,,life96,3.56,17,-1,16
283,Use the map,,snydej,4.38,16,0,16
282,Facsimile II,,snydej,4.54,14,0,14
281,Ignignokt,,shpope,1.92,94,-34,60
280,Fun with paint,,evilpettingzoo,2.45,865,-21,844
278,Return of the Robo,,abhishikt,2.18,392,-15,377
277,Outer perimeter,,themurphteam,1.83,94,-43,51
276,Flood fill,,abhishikt,2.57,99,-7,92
274,Symmetry II,,snydej,3.94,27,0,27
273,Symmetry I,,snydej,3.46,40,0,40
272,Follow the arrow,,abhishikt,3.48,32,0,32
271,Stack Magic: Episode II,,snydej,4.60,12,0,12
270,Last one,,sungjin,2.22,186,-30,156
269,Target,,sungjin,3.07,24,-2,22
268,Spining Madness,,sungjin,2.57,109,-4,105
267,Existence sign,,sungjin,2.78,96,-4,92
264,g,,sungjin,1.50,179,-38,141
263,Small Bag,,sungjin,2.32,161,-32,129
262,Star,,sungjin,1.77,1902,-192,1710
261,Facsimile,,snydej,3.91,9,0,9
260,crosshairs,,wallacoloo,3.03,35,-1,34
259,Shortening,,igoro,2.82,225,-5,220
258,Stack Magic,,snydej,4.08,28,0,28
257,Winding Path,,snydej,4.53,56,0,56
256,Counting problem,,snydej,3.75,17,-1,16
255,Ant III,,bofh,5.00,1,-1,0
254,two triangles,,wallacoloo,3.34,147,-3,144
253,Haiku Tetris,,presidenten,2.91,15,-7,8
251,Raising the Bar,,chezbriand,2.50,105,-8,97
250,diagonals,,wallacoloo,3.92,12,-1,11
249,straying from the path,,wallacoloo,2.90,244,-2,242
248,Backtracking,,recursive,3.24,20,0,20
247,"Make love, not war",,anthares,2.34,1259,-54,1205
246,Gridlock,,recursive,3.70,23,0,23
244,Waveform,,recursive,3.07,186,-2,184
243,quarter ,,nebulo,3.30,22,-1,21
242,The EU flag,,borime4ka,2.08,106,-32,74
241,Resonance 2,,esef,2.94,72,0,72
240,All Directions,,snydej,3.55,20,0,20
239,Double Staircase,,snydej,3.35,32,0,32
237,Dot,,eddy,3.38,15,-4,11
236,Getting directions...,,wallacoloo,3.40,118,-1,117
235,Resonance,,esef,2.73,34,-10,24
234,"""Shuriken""",,alvarom,2.67,76,-2,74
233,two and four,,wallacoloo,3.63,5,-1,4
232,rings,,wallacoloo,5.00,2,0,2
230,red star,,alvarom,3.07,64,-2,62
229,"2, 4, 2, 4",,wallacoloo,2.68,37,-14,23
228,spiral in then around,,wallacoloo,3.44,19,-3,16
227,propeller,,wallacoloo,2.62,445,-31,414
226,"The Big ""H""",,wallacoloo,3.58,25,0,25
225,timer,,mathew995,1.89,1287,-92,1195
224,Evil Green,,surgency,2.18,980,-74,906
223,"right on red, ??? on green",,wallacoloo,2.07,3394,-170,3224
222,good luck 3,,mathew995,1.28,25,-20,5
221,good luck 2,,mathew995,1.60,19,-21,-2
219,mr.T...,,mrthe,2.43,60,-16,44
218,Mod 3 II,,snydej,3.77,22,0,22
217,Towers,,bofh,3.24,40,0,40
216,Mod 3,,snydej,3.54,38,0,38
215,Slytherin's Locket,,traditore,2.65,61,-23,38
214,Knight's tour,,rogerio,2.29,211,-25,186
213,Can you count in binary?,,snydej,4.07,89,0,89
212,Parity Checker II,,snydej,3.36,111,0,111
211,Parity checker,,snydej,3.67,35,0,35
210,Ant II,,bofh,4.14,12,-3,9
209,Ant,,bofh,3.91,52,-4,48
208,"Roundabout Recursion ""P""",,jharkeld,3.38,14,-2,12
207,"RealHowie Home, ""Jamaica""",,realhowie,3.50,7,-3,4
206,The,,mrthe,1.84,1178,-136,1042
205,Voldemort's Wrath,,traditore,2.36,173,-55,118
204,Let the lines guide you,,igoro,2.12,1100,-39,1061
203,Just rectangles,,igoro,2.98,58,0,58
202,Smaller Field,,troc,2.52,99,-8,91
201,Square Growth,,snydej,3.19,52,-2,50
199,Fibonacci Spiral,,snydej,3.49,100,-4,96
198,Binary Counting,,snydej,4.20,14,0,14
197,RoboZZle vs Turing machine (Part III),,evko,3.64,9,0,9
196,RoboZZle vs Turing machine (Part II),,evko,4.67,6,0,6
195,Another speed control,,evko,3.32,152,0,152
194,RoboZZle vs Turing machine (Part I),,evko,4.80,12,0,12
193,Fix the path,,igoro,2.72,316,-6,310
192,Bridge Finder,,recursive,3.69,115,-1,114
191,Reversed instructions,,igoro,3.31,185,-2,183
190,Tricky kind of recursion,,homeropata,2.43,114,-31,83
189,Cherry Picking,,recursive,3.64,127,0,127
188,Cut in half,,igoro,2.61,480,-3,477
185,Explore the world 2,,igoro,3.86,24,0,24
184,One or two steps from green?,,evko,3.54,19,-2,17
183,Paint if you need,,evko,3.32,18,-4,14
182,Light goes out (simple version),,evko,3.42,18,-2,16
181,Watchtower patrol,,evko,3.44,33,0,33
180,Red lines,,evko,3.18,26,-1,25
179,LIFO to FIFO,,evko,4.15,56,-2,54
178,Right Experiment,,evko,2.84,104,-1,103
177,K,,evko,2.96,55,0,55
176,Turn on star :),,evko,4.40,23,-1,22
175,Growth,,recursive,3.50,29,0,29
173,yellow brick road,,propercalvin,1.65,28,-29,-1
172,1-2-3-4... emm... 5...,,evko,4.30,12,0,12
171,1-2-3-4-5,,evko,2.25,545,-22,523
170,Different kind of counting II,,evko,3.48,30,0,30
169,Loopy Maze,,recursive,4.00,20,0,20
168,Simple flattening,,prudnikoff,1.86,1918,-72,1846
167,Different kind of counting,,igoro,3.38,37,0,37
166,Left on green... the first time,,igoro,1.79,1800,-84,1716
165,Paint your way to the stars,,igoro,2.28,237,-8,229
164,Hidden rule,,evko,3.62,28,-1,27
163,Burst of activity ,,evko,3.33,30,-1,29
162,"""960"" on blue",,evko,3.74,115,0,115
161,Shifting colors 2,,evko,2.23,169,-15,154
160,Shifting colors,,evko,2.18,153,-33,120
159,labyrinth,,patatino,2.11,1476,-64,1412
158,Keep smilin',,prudnikoff,2.83,106,-8,98
157,Stairs to start 2,,rostik,2.17,57,-23,34
156,Stairs to star,,rostik,2.12,298,-68,230
155,Missing red tile II,,snydej,2.85,94,-2,92
154,Missing red tile,,snydej,2.48,950,-51,899
153,Wrong Turn,,recursive,3.11,193,-8,185
152,Tree,,snydej,3.76,117,-3,114
151,Graph,,recursive,2.58,385,-14,371
150,divide by 2...,,evko,2.90,94,-7,87
149,Pop goes the weasel!,,eisenhans,3.39,18,-6,12
148,Light goes out,,evko,4.25,16,0,16
147,Trial by fire,,filou,3.00,56,-6,50
146,Amazer,,filou,2.36,131,-22,109
145,Speed control,,evko,3.84,64,0,64
144,snail,,frfunny,3.88,40,-1,39
143,Double Recursion 2,,sam0737,3.26,218,-5,213
142,Single Recursion 1,,sam0737,2.31,624,-37,587
141,Double Recursion 1,,sam0737,4.08,25,-3,22
140,sh,,sam0737,1.59,4944,-440,4504
139,Duel,,aalku,1.76,764,-105,659
137,Delayed Reaction,,recursive,2.53,255,-7,248
136,plus,,bart_mc,1.99,499,-74,425
135,Getting loopy,,aaronla,2.09,379,-21,358
134,Bizarre windmill,,life96,3.95,10,-3,7
133,Can you reach the stars only by F1 & F2?,,frfunny,3.00,46,-4,42
132,Split,,recursive,2.71,305,-21,284
131,driving in the uk,,w4keme,2.00,1875,-130,1745
130,"I'm sorry, yellow have not support",,evko,3.11,28,-3,25
129,Cross,,evko,3.71,17,0,17
127,Jet-setter,,stingray,3.35,41,-3,38
126,Twice around the corner,,victor86z,2.19,317,-70,247
122,ZipBox,,evko,2.56,114,-27,87
121,(mt) ispeP,,evko,3.42,40,-3,37
120,The HAND!,,raijuzero,2.94,18,-9,9
119,Vertigo,,raijuzero,4.25,13,-2,11
118,trois couleurs,,mcris79,3.02,51,-6,45
117,Score a goal,,evko,2.49,147,-26,121
116,I'm Batman,,raijuzero,2.72,277,-20,257
115,Boxes with little corruptions,,evko,2.90,85,-6,79
114,Prison,,evko,2.95,62,-2,60
113,Nested up to madness,,evko,3.79,31,0,31
112,Dizziness,,evko,2.77,183,-6,177
111,Flooder,,evko,1.61,2734,-534,2200
110,I`m Yolko :),,evko,2.50,339,-10,329
109,Second kind of memory,,evko,3.26,304,-2,302
108,First kind of memory,,evko,2.56,183,-6,177
107,Small field,,evko,2.90,97,-12,85
106,zipline 2,,jacob_c,2.37,708,-40,668
105,zipline,,jacob_c,1.56,3939,-403,3536
104,coroutines,,jacob_c,2.34,616,-34,582
103,"left on grn, right on blu",,jacob_c,2.19,416,-30,386
102,Two kinds of memory,,evko,4.85,13,0,13
101,:),,matush,2.83,97,-10,87
100,3-2-1... Start!,,evko,3.24,35,-5,30
98,Fly in the sky II,,evko,2.37,155,-59,96
97,Smart lemma,,evko,3.68,89,0,89
96,Convex shape,,igoro,3.46,98,-9,89
95,Complex elevation,,inquirer,2.66,55,-28,27
94,Treasure Hunters,,evko,3.38,235,-6,229
93,Fly in the sky,,evko,3.77,42,-2,40
92,king's way,,evko,2.63,82,-19,63
91,Dangerous Maze,,recursive,4.59,27,0,27
90,Without blue,,glum,3.06,64,-7,57
88,Incomplete grid,,igoro,2.58,365,-13,352
87,Red run,,,3.03,288,-10,278
86,Bob's game,,,1.94,260,-165,95
85,Less or more?,,igoro,3.28,202,-1,201
84,Simple spiral,,igoro,2.46,1066,-51,1015
83,Factors of 2,,hidn,2.88,91,-16,75
82,One Star 2,,glum,3.02,130,-4,126
81,Find a way,,seka,3.67,26,-7,19
80,"RRB, RRG",,igoro,2.48,416,-4,412
78,Easy Recursion,,hidn,2.86,75,-15,60
77,Two techniques,,drus,4.00,2,-2,0
76,Count the tiles,,igoro,3.28,146,-3,143
75,Tetris,,stingray,1.94,707,-119,588
74,Knight,,stingray,2.35,357,-11,346
72,One star,,glum,1.73,2029,-241,1788
70,USSR,,nondead,1.67,910,-196,714
69,Arrows,,amazed,2.44,334,-42,292
67,Pathway,,tisba,1.31,1491,-275,1216
66,Reflection,,stingray,4.36,116,-2,114
65,Continuations,,stingray,2.85,129,-13,116
63,Humm..,,monkeyfarts,2.24,277,-40,237
62,Red green is the code II,,czvxbc,3.31,103,-8,95
61,Red-Green is the code,,igoro,2.35,435,-33,402
59,Recursion,,mandark,2.14,603,-38,565
58,Diagonale,,mandark,2.55,99,-21,78
57,8x8,,inquirer,2.12,331,-160,171
56,Turn on red ;-),,igoro,2.44,268,-3,265
55,Zig zig,,stingray,2.81,303,-6,297
54,Too easy,,czvxbc,2.65,103,-10,93
53,Branches,,igoro,3.80,133,0,133
52,Stairways to Heaven,,splattne,1.43,1354,-199,1155
51,Cartwheel,,stingray,3.36,97,-4,93
50,Where does this path lead to,,avatare,2.44,148,-58,90
49,Christmas Quilt,,crpietschmann,1.56,1071,-214,857
48,Up And Down,,crpietschmann,1.79,793,-156,637
46,Around We Go 2,,crpietschmann,1.28,2422,-385,2037
45,Around We Go 1,,crpietschmann,1.22,3101,-642,2459
44,Convergence,,,1.89,688,-91,597
43,Do while,,igoro,2.50,308,-14,294
42,The powers,,igoro,2.35,961,-54,907
41,The windmill,,poiuy,2.27,1910,-69,1841
40,Up and down the stairs,,igoro,2.21,509,-53,456
39,Smart reuse,,igoro,1.92,2715,-369,2346
38,The chambers,,igoro,2.77,114,-9,105
37,On the edge,,igoro,2.34,492,-42,450
36,Explore the world,,igoro,4.17,81,0,81
35,Kind of math...,,igoro,2.97,118,-7,111
34,Don't fall off the spiral,,igoro,3.02,273,-2,271
33,Can you count?,,igoro,3.37,169,-3,166
32,Star-studded path IV,,igoro,2.87,116,-13,103
31,Holiday stripe,,essey,2.06,99,-99,0
29,Space Invader,,,4.43,37,0,37
28,A twisty path,,,3.14,127,-57,70
27,Stairs,,,1.41,6750,-575,6175
26,Eight,,,1.83,922,-249,673
25,A window,,,2.30,664,-43,621
24,Two functions,,,1.32,3134,-455,2679
23,Two stripes,,igoro,1.69,4036,-237,3799
22,Diamond,,igoro,2.38,335,-43,292
21,Strange shape,,igoro,2.67,184,-18,166
20,Spiral to victory,,igoro,2.40,518,-19,499
19,Red loop,,igoro,1.77,1155,-82,1073
18,There can be more than one (solution),,igoro,2.08,603,-110,493
17,The star-studded path I,,igoro,2.32,752,-40,712
16,The star-studded path II,,igoro,2.32,222,-30,192
15,The star-studded path III,,igoro,2.51,227,-21,206
14,Can you reach the stars?,,igoro,3.31,358,-8,350
,,,,,,,
